"a" = (/obj/structure/table/rack,/obj/floor_decal/industrial/hatch/blue{color = "#00b8b2"},/turf/simulated/floor/tiled/old_tile,/area/template_noop)
"b" = (/obj/floor_decal/borderfloor{dir = 4},/obj/floor_decal/industrial/warning{dir = 8},/obj/structure/closet/crate/plastic,/obj/decal/cleanable/dirt,/obj/random/junkyard/medical/lite,/obj/random/junkyard/medical/lite,/obj/random/junkyard/medical/lite,/obj/random/junkyard/medical,/obj/random/junkyard/medical,/obj/random/junkyard/medical/lite,/obj/machinery/firealarm{pixel_y = 13},/turf/simulated/floor/tiled/old_cargo,/area/template_noop)
"c" = (/obj/floor_decal/borderfloor{dir = 8},/obj/floor_decal/industrial/warning{dir = 4},/turf/simulated/floor/tiled/old_cargo,/area/template_noop)
"d" = (/obj/machinery/optable,/obj/machinery/oxygen_pump{pixel_x = -28; pixel_y = 32},/obj/machinery/body_scan_display{pixel_x = 32; pixel_y = 24},/obj/floor_decal/industrial/hatch/blue{color = "#00b8b2"},/obj/machinery/light/small{dir = 1},/obj/decal/cleanable/blood,/obj/decal/cleanable/dirt,/turf/simulated/floor/tiled/old_tile,/area/template_noop)
"e" = (/obj/structure/table/standard,/obj/item/storage/firstaid/surgery{pixel_y = 10},/turf/simulated/floor/tiled/old_tile,/area/template_noop)
"f" = (/obj/floor_decal/borderfloor/corner{dir = 8},/obj/floor_decal/industrial/warning{dir = 5},/turf/simulated/floor/tiled/old_cargo,/area/template_noop)
"h" = (/obj/floor_decal/borderfloor,/obj/floor_decal/industrial/warning{dir = 1},/turf/simulated/floor/tiled/old_cargo,/area/template_noop)
"j" = (/obj/structure/iv_stand,/obj/floor_decal/borderfloor,/obj/floor_decal/industrial/warning{dir = 1},/obj/decal/cleanable/dirt,/turf/simulated/floor/tiled/old_cargo,/area/template_noop)
"k" = (/obj/floor_decal/borderfloor{dir = 1},/obj/floor_decal/industrial/warning,/obj/structure/closet/crate/medical,/obj/random/junkyard/medical,/obj/random/junkyard/medical,/obj/random/junkyard/medical,/obj/random/junkyard/medical,/turf/simulated/floor/tiled/old_cargo,/area/template_noop)
"l" = (/obj/structure/table/standard,/obj/machinery/light/small,/obj/decal/cleanable/dirt,/obj/item/defibrillator/compact/loaded{pixel_y = 3},/obj/item/storage/box/autoinjectors{pixel_x = -23; pixel_y = 9},/obj/item/storage/belt/medical,/turf/simulated/floor/tiled/old_tile,/area/template_noop)
"m" = (/obj/machinery/sleeper{dir = 1},/obj/floor_decal/industrial/hatch/blue{color = "#00b8b2"},/turf/simulated/floor/tiled/old_tile,/area/template_noop)
"n" = (/obj/floor_decal/borderfloor{dir = 8},/obj/floor_decal/industrial/warning{dir = 4},/obj/machinery/alarm{pixel_y = 24; req_access = newlist()},/turf/simulated/floor/tiled/old_cargo,/area/template_noop)
"q" = (/obj/catwalk_plated/white,/obj/machinery/atmospherics/pipe/simple/hidden/scrubbers{dir = 8},/obj/machinery/atmospherics/pipe/simple/hidden/supply{dir = 4},/obj/structure/cable/green{d1 = 4; d2 = 8; icon_state = "4-8"},/obj/decal/cleanable/blood,/turf/simulated/floor/plating,/area/template_noop)
"r" = (/obj/catwalk_plated/white,/obj/machinery/atmospherics/pipe/simple/hidden/scrubbers{dir = 8},/obj/machinery/atmospherics/pipe/simple/hidden/supply{dir = 4},/obj/structure/cable/green{d1 = 4; d2 = 8; icon_state = "4-8"},/obj/decal/cleanable/dirt,/turf/simulated/floor/plating,/area/template_noop)
"s" = (/obj/catwalk_plated/white,/obj/machinery/light/small,/turf/simulated/floor/plating,/area/template_noop)
"t" = (/obj/floor_decal/borderfloor/corner,/obj/floor_decal/industrial/warning{dir = 9},/obj/decal/cleanable/dirt,/obj/random/junkyard/advdevice,/obj/random/junkyard/tool{pixel_x = -10; pixel_y = -20},/turf/simulated/floor/tiled/old_cargo,/area/template_noop)
"v" = (/obj/machinery/vitals_monitor,/obj/floor_decal/industrial/outline/blue,/obj/decal/cleanable/cobweb,/turf/simulated/floor/tiled/old_tile,/area/template_noop)
"x" = (/obj/floor_decal/borderfloor{dir = 1},/obj/floor_decal/industrial/warning,/obj/decal/cleanable/dirt,/obj/decal/cleanable/dirt,/turf/simulated/floor/tiled/old_cargo,/area/template_noop)
"z" = (/obj/item/roller_bed,/obj/floor_decal/borderfloor,/obj/floor_decal/industrial/warning{dir = 1},/obj/decal/cleanable/dirt,/turf/simulated/floor/tiled/old_cargo,/area/template_noop)
"A" = (/obj/catwalk_plated/white,/obj/machinery/atmospherics/pipe/simple/hidden/scrubbers{dir = 8},/obj/machinery/atmospherics/pipe/simple/hidden/supply{dir = 4},/obj/structure/cable/green{d1 = 4; d2 = 8; icon_state = "4-8"},/turf/simulated/floor/plating,/area/template_noop)
"B" = (/obj/floor_decal/borderfloor{dir = 1},/obj/floor_decal/industrial/warning,/obj/structure/closet/crate/plastic,/obj/decal/cleanable/dirt,/turf/simulated/floor/tiled/old_cargo,/area/template_noop)
"D" = (/obj/floor_decal/borderfloor{dir = 4},/obj/floor_decal/industrial/warning{dir = 8},/turf/simulated/floor/tiled/old_cargo,/area/template_noop)
"E" = (/obj/structure/closet/crate/medical,/obj/machinery/light/small,/obj/decal/cleanable/dirt,/obj/random/junkyard/medical/lite,/obj/random/junkyard/medical/lite,/obj/random/junkyard/medical/lite,/obj/random/junkyard/medical/lite,/obj/random/junkyard/medical/lite,/obj/random/junkyard/medical/lite,/obj/random/junkyard/medical/lite,/obj/random/junkyard/medical/lite,/obj/random/junkyard/medical/lite,/obj/random/junkyard/medical/lite,/obj/random/junkyard/medical/lite,/turf/simulated/floor/tiled/old_tile,/area/template_noop)
"F" = (/obj/machinery/body_scanconsole{dir = 4},/obj/floor_decal/industrial/outline/blue,/obj/decal/cleanable/dirt,/turf/simulated/floor/tiled/old_tile,/area/template_noop)
"G" = (/obj/floor_decal/borderfloor/corner{dir = 4},/obj/floor_decal/industrial/warning{dir = 10},/turf/simulated/floor/tiled/old_cargo,/area/template_noop)
"H" = (/obj/floor_decal/borderfloor/corner{dir = 1},/obj/floor_decal/industrial/warning{dir = 6},/obj/decal/cleanable/dirt,/turf/simulated/floor/tiled/old_cargo,/area/template_noop)
"I" = (/obj/floor_decal/industrial/loading,/obj/decal/cleanable/dirt,/turf/simulated/floor/tiled/old_tile,/area/template_noop)
"J" = (/obj/floor_decal/borderfloor{dir = 1},/obj/floor_decal/industrial/warning,/obj/decal/cleanable/dirt,/turf/simulated/floor/tiled/old_cargo,/area/template_noop)
"K" = (/obj/catwalk_plated/white,/obj/machinery/atmospherics/pipe/simple/hidden/scrubbers{dir = 8},/obj/machinery/atmospherics/pipe/simple/hidden/supply{dir = 4},/obj/structure/cable/green{d1 = 4; d2 = 8; icon_state = "4-8"},/obj/structure/closet/crate/medical,/obj/random/junkyard/medical,/obj/random/junkyard/medical,/obj/random/junkyard/medical,/obj/random/junkyard/medical,/obj/random/junkyard/medical,/turf/simulated/floor/plating,/area/template_noop)
"L" = (/obj/catwalk_plated/white,/turf/simulated/floor/plating,/area/template_noop)
"M" = (/obj/catwalk_plated/white,/obj/machinery/light/small{dir = 1},/obj/decal/cleanable/dirt,/turf/simulated/floor/plating,/area/template_noop)
"O" = (/obj/floor_decal/borderfloor,/obj/floor_decal/industrial/warning{dir = 1},/obj/decal/cleanable/dirt,/turf/simulated/floor/tiled/old_cargo,/area/template_noop)
"Q" = (/obj/floor_decal/industrial/loading{dir = 4},/turf/simulated/floor/tiled/old_tile,/area/template_noop)
"R" = (/obj/floor_decal/borderfloor{dir = 1},/obj/floor_decal/industrial/warning,/turf/simulated/floor/tiled/old_cargo,/area/template_noop)
"S" = (/obj/item/roller_bed,/obj/decal/cleanable/blood,/obj/decal/cleanable/dirt,/turf/simulated/floor/tiled/old_tile,/area/template_noop)
"U" = (/obj/item/roller_bed,/obj/decal/cleanable/dirt,/obj/decal/cleanable/dirt,/turf/simulated/floor/tiled/old_tile,/area/template_noop)
"V" = (/obj/structure/table/standard,/obj/floor_decal/borderfloor{dir = 1},/obj/floor_decal/industrial/warning,/obj/item/storage/firstaid/adv{pixel_x = -3; pixel_y = 25},/obj/item/reagent_containers/spray/sterilizine{pixel_x = 6; pixel_y = 6},/obj/item/clothing/gloves/latex/nitrile{pixel_x = -6; pixel_y = -3},/obj/item/clothing/head/surgery/blue{pixel_x = -6; pixel_y = 7},/turf/simulated/floor/tiled/old_cargo,/area/template_noop)
"W" = (/obj/floor_decal/industrial/outline/blue,/obj/item/storage/mirror{pixel_y = 26},/obj/structure/hygiene/sink{dir = 1; pixel_y = 18},/turf/simulated/floor/tiled/old_tile,/area/template_noop)
"X" = (/obj/machinery/bodyscanner{dir = 4},/obj/floor_decal/industrial/hatch/blue{color = "#00b8b2"},/obj/machinery/light/small{dir = 1},/turf/simulated/floor/tiled/old_tile,/area/template_noop)
"Y" = (/obj/floor_decal/borderfloor{dir = 1},/obj/floor_decal/industrial/warning,/obj/decal/cleanable/generic,/turf/simulated/floor/tiled/old_cargo,/area/template_noop)
"Z" = (/obj/structure/table/standard,/obj/decal/cleanable/dirt,/obj/decal/cleanable/generic,/turf/simulated/floor/tiled/old_tile,/area/template_noop)

(1,1,1) = {"
vdeWnMbQFXI
JRVYHLGRBkx
qrKAAArAAAr
zhOjfLtOhhh
aEUScsDmZlm
"}
