"ab" = (/obj/floor_decal/borderfloorblack{dir = 8},/obj/floor_decal/corner/red/half{dir = 4},/obj/structure/table/steel_reinforced,/obj/random/medical,/turf/simulated/floor/tiled/dark/monotile,/area/map_template/facility/room20/exit)
"ag" = (/obj/floor_decal/borderfloorblack,/obj/floor_decal/corner/red/half{dir = 1},/turf/simulated/floor/tiled/dark/monotile,/area/map_template/facility/room20/exit)
"aj" = (/obj/floor_decal/spline/plain/red{dir = 1},/obj/structure/sign/warning/smoking{pixel_y = 32},/turf/simulated/floor/tiled,/area/map_template/facility/room20/exit)
"aE" = (/obj/wallframe_spawn/reinforced/crescent,/obj/structure/cable/green{d1 = 1; d2 = 8; icon_state = "1-8"},/obj/structure/cable/green{d2 = 8; icon_state = "0-8"},/turf/simulated/floor/plating,/area/map_template/facility/room20/exit)
"bc" = (/obj/floor_decal/corner/beige{dir = 6},/obj/floor_decal/borderfloor/corner{dir = 1},/obj/floor_decal/borderfloor/corner{dir = 8},/obj/machinery/newscaster{pixel_x = -32},/turf/simulated/floor/tiled/steel_ridged,/area/template_noop)
"bo" = (/obj/floor_decal/industrial/warning/corner{dir = 4},/obj/structure/sign/warning/moving_parts{pixel_y = 32},/turf/simulated/floor/tiled/steel_grid,/area/template_noop)
"bp" = (/obj/floor_decal/corner/red{dir = 5},/turf/simulated/floor/tiled/steel_ridged,/area/map_template/facility/room20/exit)
"bA" = (/obj/machinery/power/debug_items/infinite_generator{mouse_opacity = 0; alpha = 1},/obj/structure/cable/green{d2 = 4; icon_state = "0-4"},/turf/simulated/floor/tiled/dark/monotile,/area/map_template/facility/room20/exit)
"bI" = (/obj/floor_decal/borderfloorblack{dir = 4},/obj/floor_decal/corner/red{dir = 9},/obj/machinery/light{dir = 1},/obj/structure/railing/mapped{dir = 8; icon_state = "railing0-1"},/turf/simulated/floor/tiled/dark,/area/map_template/facility/room20/exit)
"cM" = (/turf/simulated/floor/tiled,/area/template_noop)
"de" = (/obj/structure/cable/green{d1 = 4; d2 = 8; icon_state = "4-8"},/turf/simulated/floor/tiled/steel_grid,/area/template_noop)
"dh" = (/obj/machinery/vending/coffee{dir = 4},/obj/floor_decal/corner/blue/half{dir = 8},/turf/simulated/floor/tiled/monotile,/area/template_noop)
"do" = (/obj/floor_decal/borderfloorblack{dir = 4},/obj/floor_decal/corner/red{dir = 9},/obj/structure/railing/mapped{dir = 8; icon_state = "railing0-1"},/turf/simulated/floor/tiled/dark,/area/map_template/facility/room20/exit)
"dt" = (/obj/floor_decal/borderfloor{dir = 1},/obj/floor_decal/corner/blue{dir = 10},/obj/random/facility/mercenary/medium,/turf/simulated/floor/tiled,/area/template_noop)
"dF" = (/obj/floor_decal/corner/red/three_quarters{dir = 1},/obj/structure/table/steel_reinforced,/obj/item/pen,/obj/item/pen/red{pixel_x = -1; pixel_y = 3},/turf/simulated/floor/tiled/dark,/area/map_template/facility/room20/exit)
"ef" = (/obj/machinery/light,/obj/structure/bed/sofa/r/black{dir = 1},/turf/simulated/floor/tiled/monotile,/area/template_noop)
"eJ" = (/obj/floor_decal/corner/beige/three_quarters{dir = 4},/obj/floor_decal/borderfloor/corner{dir = 1},/turf/simulated/floor/tiled/steel_ridged,/area/template_noop)
"eM" = (/obj/floor_decal/corner/red{dir = 5},/obj/structure/table/steel_reinforced,/obj/random/medical/lite,/obj/structure/cable/green{d1 = 1; d2 = 2; icon_state = "1-2"},/turf/simulated/floor/tiled/dark,/area/map_template/facility/room20/exit)
"fv" = (/obj/machinery/light/small{dir = 8},/turf/simulated/floor/tiled,/area/template_noop)
"fX" = (/obj/structure/cable/green{d1 = 1; d2 = 2; icon_state = "1-2"},/turf/simulated/floor/tiled/steel_ridged,/area/template_noop)
"gd" = (/obj/structure/bed/sofa/l/black{dir = 4},/obj/machinery/newscaster{pixel_x = -32},/turf/simulated/floor/tiled/monotile,/area/template_noop)
"gi" = (/obj/floor_decal/spline/plain/red,/obj/structure/cable/green{d1 = 1; d2 = 2; icon_state = "1-2"},/turf/simulated/floor/tiled/steel_grid,/area/map_template/facility/room20/exit)
"hv" = (/obj/structure/bed/sofa/l/black{dir = 8},/turf/simulated/floor/tiled/monotile,/area/template_noop)
"hS" = (/obj/floor_decal/industrial/warning,/obj/floor_decal/corner/red{dir = 5},/turf/simulated/floor/tiled/dark,/area/map_template/facility/room20/exit)
"iF" = (/obj/structure/bed/sofa/r/black{dir = 8},/obj/structure/extinguisher_cabinet{pixel_x = 32},/turf/simulated/floor/tiled/monotile,/area/template_noop)
"iW" = (/obj/wallframe_spawn/reinforced/crescent,/obj/structure/cable/green{d2 = 2; icon_state = "0-2"},/turf/simulated/floor/plating,/area/map_template/facility/room20/exit)
"ji" = (/obj/floor_decal/corner/blue{dir = 5},/obj/floor_decal/borderfloor,/obj/machinery/light/small,/turf/simulated/floor/tiled,/area/template_noop)
"jx" = (/obj/machinery/light,/obj/structure/bed/sofa/l/black{dir = 1},/turf/simulated/floor/tiled/monotile,/area/template_noop)
"jL" = (/obj/floor_decal/industrial/warning,/obj/floor_decal/corner/red{dir = 5},/obj/structure/cable/green{d1 = 4; d2 = 8; icon_state = "4-8"},/turf/simulated/floor/tiled/dark,/area/map_template/facility/room20/exit)
"jN" = (/obj/structure/holoplant,/obj/floor_decal/spline/plain/red{dir = 6},/obj/machinery/newscaster{pixel_y = -32},/turf/simulated/floor/tiled,/area/map_template/facility/room20/exit)
"kf" = (/obj/floor_decal/corner/blue/half{dir = 8},/obj/machinery/vending/cola{dir = 4},/obj/structure/cable/green{d1 = 4; d2 = 8; icon_state = "4-8"},/turf/simulated/floor/tiled/monotile,/area/template_noop)
"ki" = (/obj/structure/bed/sofa/m/black{dir = 9},/turf/simulated/floor/tiled/monotile,/area/template_noop)
"kB" = (/obj/floor_decal/corner/red{dir = 5},/obj/machinery/computer/modular/preset/security,/turf/simulated/floor/tiled/dark,/area/map_template/facility/room20/exit)
"kC" = (/obj/random/trash,/obj/structure/cable/green{d1 = 1; d2 = 2; icon_state = "1-2"},/turf/simulated/floor/tiled/steel_ridged,/area/template_noop)
"kL" = (/obj/bump_teleporter{name = "bump-teleporter to ending"; id_target = "facility_hangar_ending"},/obj/floor_decal/industrial/warning/fulltile,/obj/machinery/tele_pad{density = 0; icon_state = "pad_active"; use_power = 0},/turf/simulated/floor/reinforced,/area/map_template/facility/room20/exit)
"kV" = (/obj/structure/bed/chair/office/comfy/red{dir = 8},/turf/simulated/floor/tiled/dark,/area/map_template/facility/room20/exit)
"lr" = (/obj/floor_decal/borderfloor{dir = 8},/obj/floor_decal/corner/beige{dir = 6},/obj/random/trash,/turf/simulated/floor/tiled,/area/template_noop)
"ls" = (/obj/floor_decal/borderfloorblack{dir = 8},/obj/floor_decal/corner/red{dir = 6},/obj/structure/railing/mapped{dir = 4; icon_state = "railing0-1"},/turf/simulated/floor/tiled/dark,/area/map_template/facility/room20/exit)
"mu" = (/obj/floor_decal/corner/blue/three_quarters{dir = 1},/obj/floor_decal/borderfloor/corner{dir = 8},/turf/simulated/floor/tiled,/area/template_noop)
"mP" = (/obj/floor_decal/corner/blue{dir = 5},/obj/floor_decal/borderfloor,/obj/structure/sign/warning/nosmoking_1{dir = 4; pixel_x = -32},/turf/simulated/floor/tiled,/area/template_noop)
"mT" = (/obj/structure/cable/green{d1 = 2; d2 = 4; icon_state = "2-4"},/turf/simulated/floor/bluegrid,/area/map_template/facility/room20/exit)
"mU" = (/turf/simulated/floor/tiled/steel_ridged,/area/template_noop)
"mV" = (/obj/wallframe_spawn/reinforced/crescent,/turf/simulated/floor/plating,/area/map_template/facility/room20/exit)
"nS" = (/obj/catwalk_plated/dark,/obj/structure/cable/green{d1 = 2; d2 = 8; icon_state = "2-8"},/obj/structure/cable/green{d1 = 2; d2 = 4; icon_state = "2-4"},/turf/simulated/floor/plating,/area/map_template/facility/room20/exit)
"ot" = (/obj/structure/bed/sofa/m/black{dir = 5},/turf/simulated/floor/tiled/monotile,/area/template_noop)
"oM" = (/obj/floor_decal/borderfloorblack{dir = 8},/obj/floor_decal/corner/red{dir = 6},/obj/machinery/light{dir = 1},/obj/structure/railing/mapped{dir = 4; icon_state = "railing0-1"},/turf/simulated/floor/tiled/dark,/area/map_template/facility/room20/exit)
"oO" = (/turf/simulated/floor/greengrid,/area/map_template/facility/room20/exit)
"oS" = (/obj/floor_decal/corner/red/half{dir = 8},/obj/structure/table/standard,/obj/machinery/light{dir = 8},/obj/random/snack,/obj/random/snack,/turf/simulated/floor/tiled/monotile,/area/map_template/facility/room20/exit)
"pk" = (/obj/floor_decal/industrial/warning/fulltile,/obj/machinery/door/blast/regular{dir = 2; id_tag = "room20_ending_1"; name = "ultra durable blast door"; destroy_hits = 10000; maxhealth = 10000000; min_force = 300},/obj/structure/cable/green{d1 = 1; d2 = 2; icon_state = "1-2"},/turf/simulated/floor/tiled/steel_grid,/area/map_template/facility/room20/exit)
"pK" = (/obj/structure/cable/green{d1 = 2; d2 = 8; icon_state = "2-8"},/turf/simulated/floor/tiled,/area/template_noop)
"qp" = (/obj/floor_decal/industrial/warning/fulltile,/obj/structure/cable/green{d1 = 1; d2 = 2; icon_state = "1-2"},/obj/structure/cable/green{d1 = 1; d2 = 8; icon_state = "1-8"},/turf/simulated/floor/tiled/steel_grid,/area/map_template/facility/room20/exit)
"qQ" = (/obj/floor_decal/industrial/warning{dir = 1},/obj/structure/cable/green{d1 = 4; d2 = 8; icon_state = "4-8"},/turf/simulated/floor/tiled/steel_grid,/area/template_noop)
"qR" = (/obj/floor_decal/borderfloorblack,/obj/floor_decal/corner/red/half{dir = 1},/obj/machinery/papershredder,/obj/floor_decal/industrial/outline/yellow,/obj/machinery/recharger/wallcharger{dir = 8; pixel_x = 23; pixel_y = -3},/turf/simulated/floor/tiled/dark/monotile,/area/map_template/facility/room20/exit)
"qV" = (/obj/floor_decal/borderfloorblack{dir = 8},/obj/floor_decal/corner/red/half{dir = 4},/obj/structure/holoplant,/obj/machinery/light{dir = 8},/turf/simulated/floor/tiled/dark/monotile,/area/map_template/facility/room20/exit)
"qZ" = (/obj/machinery/light{dir = 1},/turf/simulated/floor/tiled/steel_grid,/area/template_noop)
"rv" = (/obj/floor_decal/corner/blue{dir = 6},/obj/floor_decal/borderfloor{dir = 8},/turf/simulated/floor/tiled,/area/template_noop)
"rE" = (/turf/simulated/wall/invincible/prepainted,/area/map_template/facility/room20/exit)
"sl" = (/obj/floor_decal/industrial/warning/fulltile,/obj/structure/cable/green{d1 = 4; d2 = 8; icon_state = "4-8"},/obj/structure/sign/warning/high_voltage{dir = 4; pixel_x = -32},/turf/simulated/floor/tiled/steel_grid,/area/map_template/facility/room20/exit)
"sm" = (/obj/structure/cable/green{d1 = 4; d2 = 8; icon_state = "4-8"},/turf/simulated/floor/blackgrid,/area/map_template/facility/room20/exit)
"sJ" = (/obj/structure/bed/sofa/m/black{dir = 8},/obj/floor_decal/corner/red{dir = 6},/obj/machinery/recharger/wallcharger{dir = 8; pixel_x = 23; pixel_y = -3},/turf/simulated/floor/tiled,/area/map_template/facility/room20/exit)
"sW" = (/obj/floor_decal/industrial/warning/corner,/obj/floor_decal/borderfloorblack/corner{dir = 8},/obj/floor_decal/corner/red{dir = 5},/obj/structure/railing/mapped{dir = 1; icon_state = "railing0-1"},/turf/simulated/floor/tiled/dark,/area/map_template/facility/room20/exit)
"ti" = (/obj/floor_decal/borderfloorblack{dir = 6},/obj/floor_decal/corner/red{dir = 1},/obj/machinery/light,/turf/simulated/floor/tiled/dark,/area/map_template/facility/room20/exit)
"ts" = (/obj/structure/cable/green{d1 = 4; d2 = 8; icon_state = "4-8"},/turf/simulated/floor/tiled,/area/template_noop)
"tJ" = (/obj/floor_decal/borderfloor{dir = 8},/obj/floor_decal/corner/beige{dir = 6},/obj/machinery/light/small{dir = 8},/turf/simulated/floor/tiled,/area/template_noop)
"tL" = (/obj/machinery/door/airlock/security{name = "Security Checkpoint"; stripe_color = "#FF0000"; hackProof = 1; secured_wires = 1; maxhealth = 300000; min_force = 100; destroy_hits = 10000; autoset_access = 0; req_access = list("ACCESS_FACILITY_SEC")},/obj/structure/cable/green{d1 = 1; d2 = 2; icon_state = "1-2"},/turf/simulated/floor/tiled/dark/monotile,/area/map_template/facility/room20/exit)
"uX" = (/obj/floor_decal/borderfloor{dir = 8},/obj/floor_decal/corner/beige{dir = 6},/turf/simulated/floor/tiled,/area/template_noop)
"vr" = (/obj/floor_decal/spline/plain/red,/turf/simulated/floor/tiled,/area/map_template/facility/room20/exit)
"vu" = (/obj/floor_decal/borderfloor/corner{dir = 4},/obj/floor_decal/corner/blue/three_quarters,/turf/simulated/floor/tiled,/area/template_noop)
"vF" = (/obj/floor_decal/corner/red/half{dir = 8},/obj/floor_decal/spline/plain/red{dir = 1},/obj/structure/table/standard,/obj/machinery/chemical_dispenser/bar_coffee/full{dir = 4},/turf/simulated/floor/tiled/monotile,/area/map_template/facility/room20/exit)
"vG" = (/obj/machinery/light{dir = 1},/obj/structure/cable/green{d1 = 4; d2 = 8; icon_state = "4-8"},/turf/simulated/floor/tiled/steel_grid,/area/template_noop)
"vQ" = (/obj/floor_decal/spline/plain/red{dir = 1},/obj/structure/cable/green{d1 = 1; d2 = 2; icon_state = "1-2"},/turf/simulated/floor/tiled/steel_grid,/area/map_template/facility/room20/exit)
"vS" = (/obj/catwalk_plated,/obj/structure/cable/green{d1 = 1; d2 = 2; icon_state = "1-2"},/turf/simulated/floor/plating,/area/template_noop)
"xj" = (/obj/floor_decal/corner/red/half{dir = 8},/obj/floor_decal/spline/plain/red,/obj/structure/table/standard,/obj/random/medical/lite,/turf/simulated/floor/tiled/monotile,/area/map_template/facility/room20/exit)
"xu" = (/obj/floor_decal/corner/blue{dir = 5},/obj/floor_decal/borderfloor,/obj/machinery/light/small,/obj/random/trash,/turf/simulated/floor/tiled,/area/template_noop)
"xF" = (/obj/floor_decal/industrial/warning,/obj/floor_decal/corner/red{dir = 5},/obj/structure/cable/green{d1 = 2; d2 = 4; icon_state = "2-4"},/turf/simulated/floor/tiled/dark,/area/map_template/facility/room20/exit)
"xN" = (/obj/catwalk_plated/dark,/obj/structure/bed/chair/office/comfy/red{dir = 1},/obj/structure/cable/green{d1 = 1; d2 = 2; icon_state = "1-2"},/turf/simulated/floor/plating,/area/map_template/facility/room20/exit)
"xV" = (/obj/floor_decal/industrial/warning/fulltile,/obj/machinery/door/blast/regular{dir = 2; id_tag = "room20_ending_1"; name = "ultra durable blast door"; destroy_hits = 10000; maxhealth = 10000000; min_force = 300},/turf/simulated/floor/tiled/steel_grid,/area/map_template/facility/room20/exit)
"yG" = (/obj/structure/cable/green{d1 = 1; d2 = 2; icon_state = "1-2"},/turf/simulated/floor/tiled/steel_grid,/area/map_template/facility/room20/exit)
"yN" = (/obj/machinery/door/airlock/civilian,/obj/structure/cable/green{d1 = 4; d2 = 8; icon_state = "4-8"},/turf/simulated/floor/tiled/steel_ridged,/area/template_noop)
"yP" = (/obj/floor_decal/industrial/warning/corner{dir = 1},/obj/structure/cable/green{d1 = 4; d2 = 8; icon_state = "4-8"},/obj/structure/sign/warning/secure_area{pixel_y = 32},/turf/simulated/floor/tiled/steel_grid,/area/template_noop)
"yS" = (/obj/structure/cable/green{d1 = 4; d2 = 8; icon_state = "4-8"},/turf/simulated/floor/tiled/dark,/area/map_template/facility/room20/exit)
"AR" = (/turf/simulated/wall/invincible/prepainted,/area/template_noop)
"Br" = (/obj/floor_decal/corner/red{dir = 5},/obj/structure/cable/green{d1 = 1; d2 = 8; icon_state = "1-8"},/obj/structure/cable/green{d1 = 1; d2 = 4; icon_state = "1-4"},/turf/simulated/floor/tiled/steel_grid,/area/template_noop)
"By" = (/obj/structure/bed/sofa/l/black{dir = 8},/obj/machinery/light{dir = 4},/obj/floor_decal/corner/red/three_quarters{dir = 4},/turf/simulated/floor/tiled,/area/map_template/facility/room20/exit)
"BW" = (/obj/floor_decal/corner/red{dir = 10},/turf/simulated/floor/tiled/steel_ridged,/area/template_noop)
"Cp" = (/obj/floor_decal/borderfloorblack{dir = 8},/obj/floor_decal/corner/red/half{dir = 4},/obj/structure/table/steel_reinforced,/obj/item/paper_bin{pixel_x = -3; pixel_y = 7},/obj/item/pen,/turf/simulated/floor/tiled/dark/monotile,/area/map_template/facility/room20/exit)
"CL" = (/obj/machinery/door/airlock/security{name = "Security Checkpoint"; secured_wires = 1},/obj/structure/cable/green{d1 = 1; d2 = 2; icon_state = "1-2"},/turf/simulated/floor/tiled/steel_ridged,/area/map_template/facility/room20/exit)
"CM" = (/obj/structure/cable/green{d1 = 4; d2 = 8; icon_state = "4-8"},/turf/simulated/wall/invincible/prepainted,/area/map_template/facility/room20/exit)
"DM" = (/obj/random/facility/mercenary/high,/turf/simulated/floor/tiled/steel_grid,/area/template_noop)
"DQ" = (/turf/simulated/floor/tiled/dark/monotile,/area/map_template/facility/room20/exit)
"DU" = (/obj/floor_decal/corner/blue{dir = 9},/obj/floor_decal/borderfloor{dir = 4},/turf/simulated/floor/tiled,/area/template_noop)
"Ep" = (/obj/floor_decal/borderfloorblack{dir = 8},/obj/floor_decal/corner/red{dir = 6},/obj/structure/railing/mapped{dir = 4; icon_state = "railing0-1"},/obj/structure/extinguisher_cabinet{pixel_x = -32},/turf/simulated/floor/tiled/dark,/area/map_template/facility/room20/exit)
"EK" = (/obj/machinery/door/airlock/civilian,/turf/simulated/floor/tiled/steel_ridged,/area/template_noop)
"Fj" = (/obj/structure/bed/sofa/m/black{dir = 8},/turf/simulated/floor/tiled/monotile,/area/template_noop)
"Fn" = (/obj/catwalk_plated/dark,/turf/simulated/floor/plating,/area/map_template/facility/room20/exit)
"Fu" = (/obj/floor_decal/corner/red{dir = 6},/obj/structure/cable/green{d1 = 4; d2 = 8; icon_state = "4-8"},/obj/structure/filingcabinet,/obj/floor_decal/industrial/outline/yellow,/turf/simulated/floor/tiled/dark,/area/map_template/facility/room20/exit)
"FK" = (/obj/structure/cable/green{d1 = 1; d2 = 2; icon_state = "1-2"},/turf/simulated/floor/tiled/dark,/area/map_template/facility/room20/exit)
"GL" = (/obj/floor_decal/industrial/warning{dir = 1},/turf/simulated/floor/tiled/steel_grid,/area/template_noop)
"GP" = (/obj/floor_decal/corner/red/three_quarters,/turf/simulated/floor/tiled,/area/map_template/facility/room20/exit)
"Hn" = (/obj/floor_decal/corner/red{dir = 10},/obj/structure/cable/green{d1 = 1; d2 = 2; icon_state = "1-2"},/turf/simulated/floor/tiled/steel_ridged,/area/template_noop)
"HC" = (/obj/structure/cable/green{d1 = 2; d2 = 8; icon_state = "2-8"},/turf/simulated/floor/bluegrid,/area/map_template/facility/room20/exit)
"HS" = (/obj/structure/table/standard,/obj/floor_decal/corner/red{dir = 9},/obj/random/snack,/turf/simulated/floor/tiled,/area/map_template/facility/room20/exit)
"HY" = (/obj/floor_decal/corner/red/half{dir = 8},/obj/structure/table/standard,/obj/machinery/microwave{pixel_x = -3},/obj/structure/extinguisher_cabinet{pixel_x = -32},/turf/simulated/floor/tiled/monotile,/area/map_template/facility/room20/exit)
"Iy" = (/obj/floor_decal/corner/red{dir = 6},/obj/machinery/light{dir = 4},/turf/simulated/floor/tiled/dark,/area/map_template/facility/room20/exit)
"IF" = (/obj/floor_decal/industrial/warning{dir = 1},/obj/structure/cable/green{d1 = 1; d2 = 4; icon_state = "1-4"},/turf/simulated/floor/tiled/steel_grid,/area/template_noop)
"IJ" = (/obj/floor_decal/corner/blue{dir = 5},/obj/floor_decal/borderfloor,/obj/random/facility/mercenary/medium,/turf/simulated/floor/tiled,/area/template_noop)
"JG" = (/obj/floor_decal/borderfloorblack{dir = 10},/obj/floor_decal/corner/red{dir = 4},/obj/machinery/light,/turf/simulated/floor/tiled/dark,/area/map_template/facility/room20/exit)
"Kb" = (/obj/floor_decal/borderfloor/corner{dir = 8},/obj/floor_decal/corner/beige/three_quarters{dir = 1},/turf/simulated/floor/tiled/steel_ridged,/area/template_noop)
"Kg" = (/obj/floor_decal/borderfloorblack{dir = 10},/obj/floor_decal/corner/red{dir = 4},/obj/machinery/computer/modular/preset/security{dir = 4; icon_state = "console"},/obj/machinery/light{dir = 8},/turf/simulated/floor/tiled/dark/monotile,/area/map_template/facility/room20/exit)
"Kw" = (/obj/floor_decal/plaque,/obj/structure/cable/green{d1 = 1; d2 = 2; icon_state = "1-2"},/turf/simulated/floor/tiled/steel_grid,/area/map_template/facility/room20/exit)
"KJ" = (/obj/random/trash,/obj/structure/cable/green{d1 = 4; d2 = 8; icon_state = "4-8"},/turf/simulated/floor/tiled,/area/template_noop)
"KX" = (/obj/floor_decal/corner/blue{dir = 5},/obj/floor_decal/borderfloor,/turf/simulated/floor/tiled,/area/template_noop)
"Lc" = (/obj/floor_decal/corner/red{dir = 4},/obj/structure/cable/green{d1 = 4; d2 = 8; icon_state = "4-8"},/obj/structure/sign/warning/secure_area{pixel_y = 32},/turf/simulated/floor/tiled/steel_grid,/area/template_noop)
"LC" = (/obj/structure/table/standard,/turf/simulated/floor/tiled/monotile,/area/template_noop)
"Mq" = (/obj/floor_decal/corner/red{dir = 6},/turf/simulated/floor/tiled/dark,/area/map_template/facility/room20/exit)
"MF" = (/obj/structure/cable/green{d1 = 1; d2 = 4; icon_state = "1-4"},/turf/simulated/floor/bluegrid,/area/map_template/facility/room20/exit)
"Nm" = (/obj/floor_decal/corner/beige/half{dir = 8},/obj/machinery/light/small,/turf/simulated/floor/tiled/monotile,/area/template_noop)
"Np" = (/obj/catwalk_plated,/obj/structure/cable/green{d1 = 4; d2 = 8; icon_state = "4-8"},/turf/simulated/floor/plating,/area/template_noop)
"Nw" = (/obj/floor_decal/borderfloorblack{dir = 8},/obj/floor_decal/corner/red{dir = 6},/obj/structure/railing/mapped{dir = 4; icon_state = "railing0-1"},/obj/structure/sign/warning/high_voltage{dir = 4; pixel_x = -32},/turf/simulated/floor/tiled/dark,/area/map_template/facility/room20/exit)
"On" = (/obj/floor_decal/borderfloorblack{dir = 8},/obj/floor_decal/corner/red/half{dir = 4},/obj/structure/table/steel_reinforced,/obj/machinery/button/blast_door{dir = 4; id_tag = "room20_ending_1"; name = "Facility Exit Gateway Control"; req_access = list("ACCESS_FACILITY_EXIT")},/obj/structure/cable/green{d2 = 4; icon_state = "0-4"},/turf/simulated/floor/tiled/dark/monotile,/area/map_template/facility/room20/exit)
"Ov" = (/obj/wallframe_spawn/reinforced/crescent,/obj/structure/cable/green{d2 = 2; icon_state = "0-2"},/obj/structure/cable/green{d1 = 2; d2 = 8; icon_state = "2-8"},/turf/simulated/floor/plating,/area/map_template/facility/room20/exit)
"OA" = (/turf/simulated/floor/tiled/steel_grid,/area/template_noop)
"PS" = (/obj/floor_decal/borderfloor{dir = 1},/obj/floor_decal/corner/blue{dir = 10},/obj/random/trash,/turf/simulated/floor/tiled,/area/template_noop)
"Qa" = (/obj/floor_decal/corner/blue/three_quarters{dir = 8},/obj/floor_decal/borderfloor/corner,/turf/simulated/floor/tiled,/area/template_noop)
"Qc" = (/obj/structure/bed/sofa/m/black{dir = 8},/obj/structure/extinguisher_cabinet{pixel_x = 32},/turf/simulated/floor/tiled/monotile,/area/template_noop)
"QP" = (/obj/structure/bed/sofa/l/black{dir = 10},/turf/simulated/floor/tiled/monotile,/area/template_noop)
"QX" = (/obj/floor_decal/spline/plain/red,/obj/random/facility/mercenary/low,/turf/simulated/floor/tiled,/area/map_template/facility/room20/exit)
"Rd" = (/obj/floor_decal/borderfloor{dir = 1},/obj/floor_decal/corner/blue{dir = 10},/turf/simulated/floor/tiled,/area/template_noop)
"Rw" = (/obj/structure/cable/green{d1 = 1; d2 = 8; icon_state = "1-8"},/obj/structure/cable/green{d1 = 2; d2 = 8; icon_state = "2-8"},/turf/simulated/floor/bluegrid,/area/map_template/facility/room20/exit)
"Rz" = (/obj/floor_decal/borderfloor{dir = 8},/obj/floor_decal/corner/beige{dir = 6},/obj/random/facility/mercenary/medium,/turf/simulated/floor/tiled,/area/template_noop)
"SS" = (/obj/random/trash,/obj/structure/cable/green{d1 = 1; d2 = 8; icon_state = "1-8"},/turf/simulated/floor/tiled/steel_grid,/area/template_noop)
"Ur" = (/obj/structure/cable/green{d1 = 4; d2 = 8; icon_state = "4-8"},/turf/simulated/wall/invincible/prepainted,/area/template_noop)
"Us" = (/obj/structure/cable/green{d1 = 1; d2 = 2; icon_state = "1-2"},/turf/simulated/floor/blackgrid,/area/map_template/facility/room20/exit)
"UD" = (/obj/structure/bed/sofa/l/black,/obj/floor_decal/corner/beige/half{dir = 8},/turf/simulated/floor/tiled/monotile,/area/template_noop)
"UM" = (/obj/floor_decal/borderfloorblack{dir = 4},/obj/floor_decal/corner/red{dir = 9},/obj/structure/railing/mapped{dir = 8; icon_state = "railing0-1"},/obj/structure/sign/warning/nosmoking_1{dir = 8; pixel_x = 32},/turf/simulated/floor/tiled/dark,/area/map_template/facility/room20/exit)
"Va" = (/turf/simulated/floor/tiled,/area/map_template/facility/room20/exit)
"Vv" = (/obj/structure/bed/sofa/l/black{dir = 10},/obj/floor_decal/corner/red/three_quarters{dir = 1},/turf/simulated/floor/tiled,/area/map_template/facility/room20/exit)
"Vx" = (/obj/floor_decal/industrial/warning/fulltile,/turf/simulated/floor/tiled/steel_grid,/area/map_template/facility/room20/exit)
"Wh" = (/obj/catwalk_plated/dark,/obj/structure/cable/green{d1 = 1; d2 = 8; icon_state = "1-8"},/obj/structure/cable/green{d1 = 1; d2 = 4; icon_state = "1-4"},/turf/simulated/floor/plating,/area/map_template/facility/room20/exit)
"Wn" = (/obj/floor_decal/borderfloorblack,/obj/floor_decal/corner/red/half{dir = 1},/obj/machinery/photocopier,/obj/floor_decal/industrial/outline/yellow,/turf/simulated/floor/tiled/dark/monotile,/area/map_template/facility/room20/exit)
"WD" = (/obj/machinery/light/small,/obj/structure/cable/green{d1 = 4; d2 = 8; icon_state = "4-8"},/turf/simulated/floor/tiled,/area/template_noop)
"WG" = (/obj/structure/bed/sofa/l/black,/obj/floor_decal/corner/red/three_quarters{dir = 8},/turf/simulated/floor/tiled,/area/map_template/facility/room20/exit)
"WI" = (/obj/floor_decal/corner/red{dir = 5},/obj/random/relic,/obj/floor_decal/industrial/outline/yellow,/obj/structure/closet/secure_closet{name = "Equipment Locker"; req_access = list(ACCESS_FACILITY_SEC)},/turf/simulated/floor/tiled/dark,/area/map_template/facility/room20/exit)
"WZ" = (/obj/floor_decal/industrial/warning/corner{dir = 8},/obj/floor_decal/borderfloorblack/corner,/obj/floor_decal/corner/red{dir = 5},/obj/structure/railing/mapped{dir = 1; icon_state = "railing0-1"},/obj/structure/cable/green{d1 = 1; d2 = 8; icon_state = "1-8"},/turf/simulated/floor/tiled/dark,/area/map_template/facility/room20/exit)
"Xe" = (/obj/structure/table/standard,/obj/floor_decal/corner/beige/half{dir = 8},/turf/simulated/floor/tiled/monotile,/area/template_noop)
"Xu" = (/obj/floor_decal/corner/red{dir = 1},/obj/structure/cable/green{d1 = 4; d2 = 8; icon_state = "4-8"},/turf/simulated/floor/tiled/steel_grid,/area/template_noop)
"XZ" = (/turf/unsimulated/mineral{color = "#000000"; name = "void"},/area/template_noop)
"Yy" = (/obj/wallframe_spawn/reinforced/crescent,/obj/structure/cable/green{d2 = 4; icon_state = "0-4"},/turf/simulated/floor/plating,/area/map_template/facility/room20/exit)
"YU" = (/turf/simulated/floor/tiled/dark,/area/map_template/facility/room20/exit)
"Zj" = (/obj/floor_decal/corner/red{dir = 5},/obj/structure/cable/green{d1 = 1; d2 = 2; icon_state = "1-2"},/turf/simulated/floor/tiled/steel_ridged,/area/map_template/facility/room20/exit)
"ZW" = (/obj/floor_decal/borderfloorblack,/obj/floor_decal/corner/red/half{dir = 1},/obj/structure/cable/green{d1 = 1; d2 = 2; icon_state = "1-2"},/turf/simulated/floor/tiled/dark/monotile,/area/map_template/facility/room20/exit)

(1,1,1) = {"
XZXZARARmUARARARARARARARARARARARARARXZXZ
XZXZARdhcMvuRdPSRddtRdRdRdRdRdRdRdARXZXZ
XZXZUrkfWDNpNpWDtstsWDNpNpWDKJtspKARARAR
rErErErErErErErErErErEYyOvrErEcMvSUDQPAR
rEoMmTsmsmsmHCbIrEqVWIkBeMdFrEfvvSXeFjAR
rElsUsoOoOoOUsdomVabYUFnxNMqiWcMvSNmhvAR
rENwUsoOkLoOUsdomVOnySnSWhFuaEKbkCARARAR
rElsUsoOoOoOUsdomVCpkVFKYUIyrERzvSUDQPAR
rEEpMFsmsmsmRwUMrEKgagZWWnqRrEtJvSXeQcAR
rEJGsWhSxFjLWZtirErErEtLmVmVrEuXvSNmhvAR
rErErEbpZjbprErErEvFajvQWGVvrEbcfXARARAR
rEDQrExVpkxVrEDQrEoSVayGHSsJrElrvSUDQPAR
rEbACMslqpVxrEDQrEHYVaKwGPByrEtJvSXeFjAR
rEDQrExVpkxVrEDQrExjQXgivrjNrEuXvSNmhvAR
rErErEBWHnBWrErErErErECLrErErEeJfXARARAR
EKqZboGLIFqQyPvGyNdeLcBrXudededeSSOAOAmU
ARKXKXmuDMQaKXKXARmPKXxuKXKXjiKXIJjiKXAR
ARgdLCrvOADULCiFARARARARARARARARARARARAR
ARotefrvOADUjxkiARXZXZXZXZXZXZXZXZXZXZXZ
ARARARAREKARARARARXZXZXZXZXZXZXZXZXZXZXZ
"}
