"aJ" = (/obj/floor_decal/spline/fancy/wood,/obj/structure/cable/green{d1 = 1; d2 = 8; icon_state = "1-8"},/turf/simulated/floor/tiled/dark,/area/map_template/facility/room20/living)
"bc" = (/obj/structure/bed/padded,/obj/structure/curtain/open/bed,/obj/item/bedsheet/brown,/turf/simulated/floor/carpet,/area/map_template/facility/room20/living)
"bl" = (/obj/machinery/light/small,/obj/floor_decal/corner/beige{dir = 10},/turf/simulated/floor/tiled/dark,/area/map_template/facility/room20/living)
"bo" = (/obj/structure/table/marble,/obj/floor_decal/corner/black,/obj/floor_decal/corner/black/border{dir = 1},/obj/item/reagent_containers/food/drinks/pitcher{pixel_x = 8; pixel_y = 10},/obj/item/reagent_containers/food/drinks/glass2/shot{icon_state = "shot"; pixel_x = -7},/turf/simulated/floor/tiled/white,/area/map_template/facility/room20/living)
"bp" = (/obj/structure/table/standard,/turf/simulated/floor/carpet,/area/map_template/facility/room20/living)
"bI" = (/turf/simulated/wall/invincible/prepainted,/area/map_template/facility/room20/living)
"dd" = (/obj/structure/bed/padded,/obj/structure/curtain/open/bed,/obj/item/bedsheet/brown,/turf/simulated/floor/carpet/red,/area/map_template/facility/room20/living)
"de" = (/obj/floor_decal/corner/beige{dir = 9},/obj/structure/cable/green{d1 = 4; d2 = 8; icon_state = "4-8"},/turf/simulated/floor/tiled/dark,/area/map_template/facility/room20/living)
"do" = (/obj/floor_decal/corner/lightgrey/diagonal,/obj/machinery/light/small{dir = 4; icon_state = "bulb1"},/turf/simulated/floor/tiled/white,/area/map_template/facility/room20/living)
"dH" = (/obj/floor_decal/corner/beige{dir = 9},/obj/structure/bed/sofa/l/black{dir = 4},/turf/simulated/floor/tiled/dark,/area/map_template/facility/room20/living)
"dW" = (/obj/machinery/light/small{dir = 1},/obj/structure/closet/cabinet,/obj/random/facility/clothing,/turf/simulated/floor/carpet/red,/area/map_template/facility/room20/living)
"ef" = (/obj/structure/table/standard,/obj/floor_decal/corner/beige/bordercorner{dir = 1},/turf/simulated/floor/tiled/dark/monotile,/area/map_template/facility/room20/living)
"eJ" = (/obj/structure/closet/cabinet,/obj/random/facility/clothing,/obj/random/cash,/turf/simulated/floor/carpet,/area/map_template/facility/room20/living)
"eY" = (/obj/machinery/door/airlock/civilian{name = "Living Rooms"},/obj/floor_decal/corner/beige,/obj/structure/cable/green{d1 = 4; d2 = 8; icon_state = "4-8"},/turf/simulated/floor/tiled/dark/monotile,/area/map_template/facility/room20/living)
"fv" = (/obj/machinery/light/small{dir = 4; icon_state = "bulb1"},/turf/simulated/floor/wood/walnut,/area/map_template/facility/room20/living)
"fQ" = (/obj/floor_decal/borderfloor{dir = 1},/obj/floor_decal/corner/lightgrey,/obj/machinery/washing_machine{pixel_y = 19},/turf/simulated/floor/tiled/white,/area/map_template/facility/room20/living)
"gd" = (/turf/simulated/floor/carpet/red,/area/map_template/facility/room20/living)
"gt" = (/obj/floor_decal/corner/beige/border,/obj/machinery/light/small{dir = 1},/turf/simulated/floor/tiled/dark/monotile,/area/map_template/facility/room20/living)
"hf" = (/obj/floor_decal/corner/beige{dir = 9},/turf/simulated/floor/tiled/dark,/area/map_template/facility/room20/living)
"hv" = (/obj/floor_decal/spline/fancy/wood/corner{dir = 1},/obj/floor_decal/corner/beige/half{dir = 8},/obj/structure/cable/green{d1 = 1; d2 = 2; icon_state = "1-2"},/turf/simulated/floor/tiled/dark/monotile,/area/map_template/facility/room20/living)
"hE" = (/obj/floor_decal/corner/beige{dir = 9},/obj/structure/bed/sofa/m/black{dir = 4},/turf/simulated/floor/tiled/dark,/area/map_template/facility/room20/living)
"hS" = (/obj/structure/bed/sofa/l/black,/turf/simulated/floor/carpet,/area/map_template/facility/room20/living)
"ic" = (/obj/structure/cable/green{d1 = 4; d2 = 8; icon_state = "4-8"},/turf/simulated/floor/tiled/dark,/area/map_template/facility/room20/living)
"is" = (/obj/machinery/light/small,/obj/structure/table/woodentable,/obj/item/deck/cards,/obj/item/reagent_containers/food/drinks/glass2/rocks{icon_state = "rocks"; pixel_y = 11},/turf/simulated/floor/carpet/red,/area/map_template/facility/room20/living)
"it" = (/obj/structure/bed/padded,/obj/item/bedsheet,/obj/structure/curtain/open/bed,/turf/simulated/floor/carpet,/area/map_template/facility/room20/living)
"iv" = (/obj/structure/bed/sofa/l/black{dir = 4},/turf/simulated/floor/carpet/red,/area/map_template/facility/room20/living)
"ji" = (/obj/machinery/door/unpowered/simple/iron,/turf/simulated/floor/tiled/dark/monotile,/area/map_template/facility/room20/living)
"jx" = (/obj/floor_decal/spline/fancy/wood,/obj/floor_decal/spline/fancy/wood{dir = 1},/obj/machinery/light/small{dir = 8},/turf/simulated/floor/wood/walnut,/area/map_template/facility/room20/living)
"jR" = (/obj/structure/bed/chair/padded/blue,/obj/floor_decal/corner/beige/border{dir = 8},/turf/simulated/floor/tiled/dark/monotile,/area/map_template/facility/room20/living)
"ki" = (/obj/machinery/door/airlock/civilian{name = "Luxury Living Room"},/obj/floor_decal/corner/beige/border{dir = 4},/turf/simulated/floor/tiled/dark/monotile,/area/map_template/facility/room20/living)
"kC" = (/obj/structure/table/standard,/obj/floor_decal/corner/beige/border{dir = 8},/turf/simulated/floor/tiled/dark/monotile,/area/map_template/facility/room20/living)
"kL" = (/obj/structure/table/marble,/obj/machinery/microwave{pixel_x = -3; pixel_y = 6},/obj/floor_decal/corner/black,/obj/floor_decal/corner/black/border{dir = 1},/turf/simulated/floor/tiled/white,/area/map_template/facility/room20/living)
"lr" = (/obj/machinery/light/small{dir = 8},/obj/floor_decal/spline/fancy/wood{dir = 4},/obj/floor_decal/corner/beige{dir = 9},/obj/structure/cable/green{d1 = 1; d2 = 2; icon_state = "1-2"},/turf/simulated/floor/tiled/dark,/area/map_template/facility/room20/living)
"ls" = (/obj/structure/table/standard,/obj/floor_decal/corner/beige/border{dir = 1},/obj/random/cash,/turf/simulated/floor/tiled/dark/monotile,/area/map_template/facility/room20/living)
"lI" = (/obj/floor_decal/spline/fancy/wood{dir = 8},/obj/random/facility/mercenary/high,/turf/simulated/floor/wood/walnut,/area/map_template/facility/room20/living)
"mu" = (/obj/random/facility/mercenary/medium,/turf/simulated/floor/tiled/dark,/area/map_template/facility/room20/living)
"mU" = (/obj/floor_decal/corner/beige{dir = 8},/turf/simulated/floor/tiled/dark/monotile,/area/map_template/facility/room20/living)
"nr" = (/obj/floor_decal/corner/beige/border{dir = 1},/obj/structure/table/rack,/turf/simulated/floor/tiled/dark/monotile,/area/map_template/facility/room20/living)
"ny" = (/obj/floor_decal/borderfloor,/obj/floor_decal/corner/lightgrey{dir = 1},/obj/structure/hygiene/toilet{dir = 8},/turf/simulated/floor/tiled/white,/area/map_template/facility/room20/living)
"ot" = (/obj/catwalk_plated/dark,/obj/structure/cable/green{d1 = 4; d2 = 8; icon_state = "4-8"},/turf/simulated/floor/plating,/area/map_template/facility/room20/living)
"oM" = (/obj/structure/cable/green{d1 = 1; d2 = 2; icon_state = "1-2"},/turf/simulated/floor/tiled/dark,/area/map_template/facility/room20/living)
"oO" = (/obj/structure/table/standard,/turf/simulated/floor/tiled/dark,/area/map_template/facility/room20/living)
"qr" = (/obj/structure/cable/green{d1 = 4; d2 = 8; icon_state = "4-8"},/turf/simulated/wall/invincible/prepainted,/area/map_template/facility/room20/living)
"qS" = (/obj/structure/table/woodentable,/obj/random/single/cola{pixel_x = 7; pixel_y = 8},/obj/item/reagent_containers/food/drinks/teapot,/turf/simulated/floor/carpet/red,/area/map_template/facility/room20/living)
"rv" = (/obj/floor_decal/corner/beige{dir = 10},/obj/structure/bed/sofa/r/black{dir = 1},/turf/simulated/floor/tiled/dark,/area/map_template/facility/room20/living)
"sl" = (/obj/structure/holoplant{pixel_y = 10},/obj/floor_decal/corner/beige/border{dir = 10},/obj/structure/cable/green{d1 = 2; d2 = 8; icon_state = "2-8"},/turf/simulated/floor/tiled/dark/monotile,/area/map_template/facility/room20/living)
"sm" = (/obj/structure/closet/secure_closet/guncabinet,/obj/floor_decal/corner/red/border{dir = 8},/obj/random/facility/ammo,/obj/random/facility/gun/uncommon,/turf/simulated/floor/tiled/dark/monotile,/area/map_template/facility/room20/living)
"sE" = (/turf/simulated/wall/prepainted,/area/map_template/facility/room20/living)
"sH" = (/obj/structure/bed/chair/padded/blue,/obj/floor_decal/corner/red/border{dir = 8},/turf/simulated/floor/tiled/dark/monotile,/area/map_template/facility/room20/living)
"sS" = (/obj/machinery/light/small{dir = 1},/turf/simulated/floor/carpet,/area/map_template/facility/room20/living)
"sW" = (/obj/floor_decal/spline/fancy/wood{dir = 1},/turf/simulated/floor/wood/walnut,/area/map_template/facility/room20/living)
"ti" = (/obj/structure/cable/green{d1 = 2; d2 = 4; icon_state = "2-4"},/turf/simulated/floor/tiled/dark,/area/map_template/facility/room20/living)
"tJ" = (/obj/structure/holoplant,/turf/simulated/floor/wood/walnut,/area/map_template/facility/room20/living)
"uX" = (/turf/simulated/floor/wood/walnut,/area/map_template/facility/room20/living)
"vn" = (/obj/catwalk_plated/dark,/obj/structure/cable/green{d1 = 1; d2 = 2; icon_state = "1-2"},/obj/random/facility/mercenary/medium,/turf/simulated/floor/plating,/area/map_template/facility/room20/living)
"vu" = (/turf/unsimulated/mineral{color = "#000000"; name = "void"},/area/map_template/facility/room20/living)
"vG" = (/obj/floor_decal/corner/lightgrey/diagonal,/obj/structure/hygiene/drain,/turf/simulated/floor/tiled/white,/area/map_template/facility/room20/living)
"vL" = (/obj/structure/hygiene/shower{pixel_y = 23},/obj/floor_decal/borderfloor{dir = 1},/obj/floor_decal/corner/lightgrey,/turf/simulated/floor/tiled/white,/area/map_template/facility/room20/living)
"vS" = (/obj/floor_decal/corner/beige{dir = 10},/turf/simulated/floor/tiled/dark,/area/map_template/facility/room20/living)
"wO" = (/obj/floor_decal/corner/beige{dir = 10},/obj/structure/bed/sofa/m/black{dir = 1},/turf/simulated/floor/tiled/dark,/area/map_template/facility/room20/living)
"xu" = (/obj/floor_decal/corner/beige{dir = 10},/obj/structure/cable/green{d1 = 1; d2 = 8; icon_state = "1-8"},/turf/simulated/floor/tiled/dark,/area/map_template/facility/room20/living)
"yP" = (/obj/structure/closet/cabinet,/obj/floor_decal/corner/beige/border{dir = 1},/obj/random/facility/clothing,/turf/simulated/floor/tiled/dark/monotile,/area/map_template/facility/room20/living)
"zb" = (/obj/floor_decal/corner/beige/border{dir = 8},/obj/machinery/light/small{dir = 4; icon_state = "bulb1"},/turf/simulated/floor/tiled/dark/monotile,/area/map_template/facility/room20/living)
"zm" = (/obj/structure/curtain/black,/obj/floor_decal/corner/beige{dir = 4},/obj/floor_decal/corner/beige/border{dir = 8},/turf/simulated/floor/tiled/dark/monotile,/area/map_template/facility/room20/living)
"zt" = (/obj/machinery/light/small{dir = 4},/turf/simulated/floor/carpet,/area/map_template/facility/room20/living)
"zv" = (/obj/structure/table/standard,/obj/floor_decal/corner/beige/border{dir = 1},/turf/simulated/floor/tiled/dark/monotile,/area/map_template/facility/room20/living)
"zK" = (/obj/floor_decal/corner/beige{dir = 10},/obj/structure/cable/green{d1 = 4; d2 = 8; icon_state = "4-8"},/turf/simulated/floor/tiled/dark,/area/map_template/facility/room20/living)
"BI" = (/obj/floor_decal/corner/beige/border,/obj/machinery/light/small{dir = 1},/obj/structure/table/rack,/turf/simulated/floor/tiled/dark/monotile,/area/map_template/facility/room20/living)
"DC" = (/obj/structure/closet/kitchen{icon = 'icons/obj/closets/fridge.dmi'; closet_appearance = null; name = "fridge"},/obj/floor_decal/corner/black,/obj/floor_decal/corner/black/border{dir = 1},/turf/simulated/floor/tiled/white,/area/map_template/facility/room20/living)
"DU" = (/obj/catwalk_plated/dark,/obj/structure/cable/green{d1 = 1; d2 = 2; icon_state = "1-2"},/turf/simulated/floor/plating,/area/map_template/facility/room20/living)
"DZ" = (/obj/floor_decal/spline/fancy/wood/corner{dir = 4},/obj/machinery/light/small,/turf/simulated/floor/wood/walnut,/area/map_template/facility/room20/living)
"Eh" = (/obj/random/facility/mercenary/low,/turf/simulated/floor/carpet/red,/area/map_template/facility/room20/living)
"Ex" = (/obj/structure/bed/sofa/l/black{dir = 8},/turf/simulated/floor/carpet,/area/map_template/facility/room20/living)
"EK" = (/obj/machinery/door/airlock/civilian{name = "Living Rooms"},/turf/simulated/floor/tiled/dark/monotile,/area/map_template/facility/room20/living)
"Fj" = (/obj/floor_decal/spline/fancy/wood/corner,/obj/floor_decal/corner/beige{dir = 9},/obj/structure/cable/green{d1 = 2; d2 = 4; icon_state = "2-4"},/turf/simulated/floor/tiled/dark,/area/map_template/facility/room20/living)
"GE" = (/obj/structure/bed/chair/comfy/brown{dir = 8},/turf/simulated/floor/carpet/red,/area/map_template/facility/room20/living)
"Hn" = (/obj/floor_decal/corner/beige/border{dir = 4},/turf/simulated/floor/tiled/dark/monotile,/area/map_template/facility/room20/living)
"HC" = (/obj/structure/bed/chair/padded/blue{dir = 8},/obj/floor_decal/corner/beige/border{dir = 1},/turf/simulated/floor/tiled/dark/monotile,/area/map_template/facility/room20/living)
"IF" = (/obj/structure/closet/cabinet,/obj/random/facility/clothing,/turf/simulated/floor/carpet,/area/map_template/facility/room20/living)
"IO" = (/obj/structure/table/standard,/obj/floor_decal/corner/red/bordercorner{dir = 1},/obj/item/card/id/facility/sec,/turf/simulated/floor/tiled/dark/monotile,/area/map_template/facility/room20/living)
"Js" = (/obj/structure/table/marble,/obj/floor_decal/corner/black,/obj/floor_decal/corner/black/border{dir = 1},/obj/structure/hygiene/sink/kitchen{pixel_y = 29},/obj/item/reagent_containers/food/drinks/glass2/coffeecup/teacup{pixel_x = 6},/turf/simulated/floor/tiled/white,/area/map_template/facility/room20/living)
"JG" = (/obj/structure/table/standard,/obj/floor_decal/corner/beige/bordercorner{dir = 4},/turf/simulated/floor/tiled/dark/monotile,/area/map_template/facility/room20/living)
"Kb" = (/obj/floor_decal/corner/beige/border{dir = 8},/obj/structure/closet/cabinet,/obj/random/facility/clothing,/obj/random/cash,/turf/simulated/floor/tiled/dark/monotile,/area/map_template/facility/room20/living)
"Kn" = (/obj/floor_decal/corner/beige/border,/obj/structure/table/woodentable,/turf/simulated/floor/tiled/dark/monotile,/area/map_template/facility/room20/living)
"KB" = (/obj/floor_decal/corner/beige{dir = 10},/obj/structure/cable/green{d1 = 1; d2 = 2; icon_state = "1-2"},/turf/simulated/floor/tiled/dark,/area/map_template/facility/room20/living)
"KD" = (/obj/floor_decal/corner/beige{dir = 5},/turf/simulated/floor/tiled/dark,/area/map_template/facility/room20/living)
"KF" = (/obj/structure/holoplant{pixel_y = 10},/obj/floor_decal/corner/beige/border{dir = 6},/turf/simulated/floor/tiled/dark/monotile,/area/map_template/facility/room20/living)
"KJ" = (/obj/floor_decal/spline/fancy/wood,/obj/floor_decal/spline/fancy/wood{dir = 1},/turf/simulated/floor/wood/walnut,/area/map_template/facility/room20/living)
"KS" = (/obj/machinery/light/small{dir = 4; icon_state = "bulb1"},/obj/structure/bed/sofa/m/black{dir = 8},/turf/simulated/floor/carpet,/area/map_template/facility/room20/living)
"KX" = (/obj/structure/cable/green{d1 = 1; d2 = 2; icon_state = "1-2"},/turf/simulated/wall/invincible/prepainted,/area/map_template/facility/room20/living)
"Lk" = (/obj/structure/bed/sofa/r/black{dir = 4},/turf/simulated/floor/carpet/red,/area/map_template/facility/room20/living)
"Lu" = (/obj/machinery/light/small{dir = 4; icon_state = "bulb1"},/turf/simulated/floor/carpet,/area/map_template/facility/room20/living)
"LC" = (/obj/structure/table/rack,/obj/random/facility/ammo,/obj/floor_decal/corner/red/border{dir = 1},/turf/simulated/floor/tiled/dark/monotile,/area/map_template/facility/room20/living)
"LL" = (/obj/floor_decal/spline/fancy/wood{dir = 8},/turf/simulated/floor/wood/walnut,/area/map_template/facility/room20/living)
"LR" = (/obj/machinery/cooker/oven,/obj/floor_decal/corner/black,/obj/floor_decal/corner/black/border{dir = 1},/obj/machinery/light/small{dir = 1},/turf/simulated/floor/tiled/white,/area/map_template/facility/room20/living)
"Mv" = (/obj/random/facility/mercenary/high,/turf/simulated/floor/carpet/red,/area/map_template/facility/room20/living)
"MU" = (/obj/floor_decal/corner/beige/border{dir = 8},/turf/simulated/floor/tiled/dark/monotile,/area/map_template/facility/room20/living)
"Nm" = (/obj/random/facility/clothing,/obj/structure/closet/cabinet,/turf/simulated/floor/carpet,/area/map_template/facility/room20/living)
"Pc" = (/obj/floor_decal/spline/fancy/wood,/turf/simulated/floor/tiled/dark,/area/map_template/facility/room20/living)
"Pw" = (/obj/floor_decal/spline/fancy/wood/corner{dir = 4},/obj/floor_decal/spline/fancy/wood/corner{dir = 8},/turf/simulated/floor/wood/walnut,/area/map_template/facility/room20/living)
"PS" = (/obj/floor_decal/corner/beige/border{dir = 4},/obj/structure/table/rack,/turf/simulated/floor/tiled/dark/monotile,/area/map_template/facility/room20/living)
"Qa" = (/obj/structure/table/standard,/obj/floor_decal/corner/beige/border{dir = 1},/obj/item/reagent_containers/food/drinks/glass2/coffeecup/teacup{pixel_x = 6},/turf/simulated/floor/tiled/dark/monotile,/area/map_template/facility/room20/living)
"Qp" = (/obj/floor_decal/spline/fancy/wood{dir = 4},/obj/floor_decal/corner/beige{dir = 9},/obj/structure/cable/green{d1 = 1; d2 = 2; icon_state = "1-2"},/turf/simulated/floor/tiled/dark,/area/map_template/facility/room20/living)
"QP" = (/obj/floor_decal/corner/beige{dir = 5},/obj/structure/bed/chair/comfy/brown,/turf/simulated/floor/tiled/dark,/area/map_template/facility/room20/living)
"Rd" = (/obj/floor_decal/corner/beige/bordercorner{dir = 8},/obj/structure/cable/green{d1 = 1; d2 = 4; icon_state = "1-4"},/turf/simulated/floor/tiled/dark/monotile,/area/map_template/facility/room20/living)
"Rp" = (/obj/floor_decal/corner/beige/border{dir = 1},/turf/simulated/floor/tiled/dark/monotile,/area/map_template/facility/room20/living)
"Rs" = (/obj/floor_decal/corner/black{dir = 1},/obj/floor_decal/corner/black/border,/turf/simulated/floor/tiled/white,/area/map_template/facility/room20/living)
"Sg" = (/obj/floor_decal/corner/beige/border,/obj/structure/coatrack,/turf/simulated/floor/tiled/dark/monotile,/area/map_template/facility/room20/living)
"Sn" = (/obj/catwalk_plated/dark,/obj/structure/cable/green{d1 = 4; d2 = 8; icon_state = "4-8"},/obj/random/facility/mercenary/medium,/turf/simulated/floor/plating,/area/map_template/facility/room20/living)
"SS" = (/obj/machinery/light/small{dir = 8},/obj/floor_decal/corner/beige{dir = 9},/turf/simulated/floor/tiled/dark,/area/map_template/facility/room20/living)
"Tz" = (/obj/machinery/light/small,/turf/simulated/floor/carpet,/area/map_template/facility/room20/living)
"Uf" = (/obj/floor_decal/corner/red/border{dir = 1},/turf/simulated/floor/tiled/dark/monotile,/area/map_template/facility/room20/living)
"Ur" = (/obj/machinery/light/small{dir = 8},/turf/simulated/floor/carpet,/area/map_template/facility/room20/living)
"UD" = (/obj/machinery/door/airlock/civilian{name = "Living Rooms"},/obj/floor_decal/corner/beige{dir = 1},/obj/structure/cable/green{d1 = 1; d2 = 2; icon_state = "1-2"},/turf/simulated/floor/tiled/dark/monotile,/area/map_template/facility/room20/living)
"Va" = (/obj/machinery/door/unpowered/simple/plastic,/turf/simulated/floor/tiled/white/monotile,/area/map_template/facility/room20/living)
"Vx" = (/obj/floor_decal/corner/beige/border{dir = 6},/obj/structure/table/rack,/obj/random/facility/clothing,/turf/simulated/floor/tiled/dark/monotile,/area/map_template/facility/room20/living)
"Wr" = (/turf/simulated/floor/carpet,/area/map_template/facility/room20/living)
"Ws" = (/obj/floor_decal/corner/beige/border{dir = 8},/obj/structure/closet/cabinet,/obj/random/facility/clothing,/turf/simulated/floor/tiled/dark/monotile,/area/map_template/facility/room20/living)
"WD" = (/obj/floor_decal/spline/fancy/wood/corner{dir = 1},/obj/machinery/light/small,/turf/simulated/floor/wood/walnut,/area/map_template/facility/room20/living)
"WE" = (/obj/structure/closet/cabinet,/obj/floor_decal/corner/beige/border{dir = 1},/obj/random/facility/clothing,/obj/random/cash,/turf/simulated/floor/tiled/dark/monotile,/area/map_template/facility/room20/living)
"WZ" = (/obj/structure/bed/sofa/l/black{dir = 10},/turf/simulated/floor/carpet,/area/map_template/facility/room20/living)
"Xe" = (/obj/floor_decal/corner/beige/border,/obj/machinery/light/small,/obj/structure/table/woodentable,/obj/random/facility/gun/rare,/turf/simulated/floor/tiled/dark/monotile,/area/map_template/facility/room20/living)
"XX" = (/obj/floor_decal/borderfloor,/obj/floor_decal/corner/lightgrey{dir = 1},/turf/simulated/floor/tiled/white,/area/map_template/facility/room20/living)
"XZ" = (/obj/floor_decal/corner/beige/three_quarters,/obj/structure/bed/sofa/m/black{dir = 5},/turf/simulated/floor/tiled/dark,/area/map_template/facility/room20/living)
"YJ" = (/obj/floor_decal/corner/beige/border,/turf/simulated/floor/tiled/dark/monotile,/area/map_template/facility/room20/living)
"ZV" = (/obj/floor_decal/spline/fancy/wood/corner{dir = 8},/obj/floor_decal/spline/fancy/wood{dir = 1},/turf/simulated/floor/wood/walnut,/area/map_template/facility/room20/living)

(1,1,1) = {"
bIbIbIbImUbIbIbIbIbIbIbIbIbIbIbIbIbIbIbI
bIvuvuqrdeslsEPSWrbcsEkLboJsLRDCsEfQvLbI
bIbIbIbISSoMjiHnWrztsERsRsRsRsRsVavGdobI
bIitIFsEhfvnsEJGHCWEsEjxKJKJZVsWsEXXnybI
bIUrWrjihfDUsEsEsEsEsEivqSMvLLfvsEsEsEbI
bIlsHCsEhfoMjiWrsSitsELkisGELLuXsENmitbI
bIsEsEsESSDUsEzvHCyPsEsEsEsEPwuXsEWrLubI
bIitIFsEhfDUsEsEsEsEsESgBIVxlIuXzmKDQPbI
bIUrWrjiFjaJPcMUkiuXWDsWsWsWDZtJsEXeKnbI
bIzvHCsEQphSWZsEsEsEsEsEsEsEsEsEsEsEsEbI
bIsEsEsElrbpKSsEdddWsmsEbcsSWssEbcsSKbbI
bIitIFsEQpbpExsEgdEhsHsEWrWrjRsEWrWrjRbI
bIUrWrjiQpTzWrsELCUfIOsEnrRpefsEnrRpefbI
bIQaHCsEhvsEsEsEsEjisEsEsEjisEsEsEjisEbI
bIsEsEsEUDsEKFtiototicotototicSnoticslbI
EKYJgtYJRdeYzKxuvSblvSvSvSblvSvSvSblKBmU
bIdHoOmuMUsEsEjisEsEsEjisEsEsEjisEbIKXbI
bIhEoOoOzbsEeJWrjRsEIFWrjRsEIFWrjRbIvubI
bIXZwOrvMUsEitTzkCsEitTzkCsEitTzkCbIvubI
bIbIbIbIEKbIbIbIbIbIbIbIbIbIbIbIbIbIbIbI
"}
