"aJ" = (/obj/floor_decal/corner/blue{dir = 6},/obj/machinery/light{dir = 4},/obj/random/trash,/turf/simulated/floor/tiled,/area/map_template/facility/start)
"bc" = (/turf/simulated/floor/tiled/dark,/area/map_template/facility/start)
"bl" = (/obj/floor_decal/corner/red{dir = 4},/turf/simulated/floor/tiled,/area/map_template/facility/start)
"bo" = (/obj/floor_decal/borderfloorblack/corner{dir = 8},/obj/floor_decal/corner/blue/three_quarters{dir = 1},/obj/structure/holoplant{pixel_y = 10},/turf/simulated/floor/tiled/dark,/area/map_template/facility/start)
"bp" = (/obj/floor_decal/corner/red{dir = 1},/obj/floor_decal/corner/blue{dir = 4},/obj/structure/sign/warning/secure_area{pixel_y = 32},/turf/simulated/floor/tiled,/area/map_template/facility/start)
"bI" = (/turf/unsimulated/mineral{color = "#000000"; name = "void"},/area/map_template/facility/start)
"dd" = (/obj/floor_decal/corner/blue{dir = 5},/obj/random/trash,/turf/simulated/floor/tiled,/area/map_template/facility/start)
"de" = (/turf/simulated/floor/tiled/steel_grid,/area/map_template/facility/start)
"do" = (/obj/floor_decal/borderfloorblack{dir = 4},/obj/floor_decal/corner/red{dir = 9},/obj/structure/railing/mapped{dir = 8; icon_state = "railing0-1"},/turf/simulated/floor/tiled/dark,/area/map_template/facility/start)
"dv" = (/obj/floor_decal/borderfloorblack{dir = 4},/obj/floor_decal/corner/blue{dir = 9},/obj/random/facility/gun/uncommon,/obj/landmark/corpse/facility/mercenary,/turf/simulated/floor/tiled/dark,/area/map_template/facility/start)
"dH" = (/obj/floor_decal/corner/blue{dir = 10},/obj/structure/holoplant,/turf/simulated/floor/tiled,/area/map_template/facility/start)
"dW" = (/obj/floor_decal/corner/blue{dir = 5},/obj/floor_decal/corner/red,/obj/structure/sign/warning/nosmoking_1{pixel_y = 24},/obj/machinery/light/small{dir = 4; icon_state = "bulb1"},/obj/machinery/vending/coffee,/turf/simulated/floor/tiled,/area/map_template/facility/start)
"ef" = (/obj/floor_decal/corner/red/mono,/obj/structure/table/steel_reinforced,/obj/machinery/chemical_dispenser/bar_coffee/full{dir = 1},/turf/simulated/floor/tiled/dark/monotile,/area/map_template/facility/start)
"eJ" = (/obj/floor_decal/borderfloorblack,/obj/floor_decal/corner/blue{dir = 5},/obj/structure/bed/chair/padded/blue,/turf/simulated/floor/tiled/dark,/area/map_template/facility/start)
"eY" = (/obj/floor_decal/borderfloorblack{dir = 8},/obj/floor_decal/corner/blue{dir = 6},/obj/random/trash,/turf/simulated/floor/tiled/dark,/area/map_template/facility/start)
"fv" = (/obj/floor_decal/industrial/warning{dir = 10},/turf/simulated/floor/reinforced,/area/map_template/facility/start)
"fQ" = (/obj/floor_decal/borderfloorblack{dir = 1},/obj/floor_decal/corner/red{dir = 10},/obj/structure/railing/mapped,/turf/simulated/floor/tiled/dark,/area/map_template/facility/start)
"gd" = (/obj/floor_decal/corner/red{dir = 6},/turf/simulated/floor/tiled/steel_grid,/area/map_template/facility/start)
"gt" = (/obj/floor_decal/corner/blue,/turf/simulated/floor/tiled,/area/map_template/facility/start)
"hf" = (/obj/floor_decal/borderfloorblack/corner,/obj/floor_decal/corner/blue/three_quarters{dir = 8},/obj/structure/table/standard,/obj/random/smokes,/turf/simulated/floor/tiled/dark,/area/map_template/facility/start)
"hv" = (/obj/floor_decal/corner/blue{dir = 5},/obj/machinery/light/small{dir = 1},/turf/simulated/floor/tiled,/area/map_template/facility/start)
"hE" = (/obj/floor_decal/corner/red/border{dir = 8},/obj/floor_decal/borderfloorblack{dir = 4},/obj/structure/table/steel_reinforced,/obj/item/paper_bin,/obj/item/pen,/turf/simulated/floor/tiled/dark/monotile,/area/map_template/facility/start)
"hS" = (/obj/floor_decal/corner/red,/obj/floor_decal/corner/blue{dir = 4},/turf/simulated/floor/tiled,/area/map_template/facility/start)
"ic" = (/obj/floor_decal/corner/blue{dir = 5},/turf/simulated/floor/tiled,/area/map_template/facility/start)
"is" = (/obj/floor_decal/borderfloorblack{dir = 8},/obj/floor_decal/corner/blue{dir = 6},/turf/simulated/floor/tiled/dark,/area/map_template/facility/start)
"it" = (/obj/structure/hygiene/toilet{dir = 1},/obj/floor_decal/borderfloor,/turf/simulated/floor/tiled/monotile,/area/map_template/facility/start)
"iv" = (/obj/floor_decal/borderfloorblack{dir = 4},/obj/floor_decal/corner/blue{dir = 9},/obj/machinery/light{dir = 8},/turf/simulated/floor/tiled/dark,/area/map_template/facility/start)
"ji" = (/obj/floor_decal/corner/blue{dir = 10},/obj/machinery/light,/turf/simulated/floor/tiled,/area/map_template/facility/start)
"jx" = (/obj/floor_decal/borderfloorblack{dir = 4},/obj/floor_decal/corner/blue{dir = 9},/obj/structure/sign/warning/nosmoking_1{dir = 4; pixel_x = -32},/turf/simulated/floor/tiled/dark,/area/map_template/facility/start)
"jR" = (/obj/floor_decal/corner/red/three_quarters{dir = 4},/obj/floor_decal/borderfloorblack/corner{dir = 1},/obj/machinery/light{dir = 4},/turf/simulated/floor/tiled/dark,/area/map_template/facility/start)
"ki" = (/obj/floor_decal/borderfloorblack{dir = 1},/obj/floor_decal/corner/blue{dir = 10},/turf/simulated/floor/tiled/dark,/area/map_template/facility/start)
"kC" = (/obj/floor_decal/corner/blue{dir = 6},/obj/machinery/light{dir = 4},/turf/simulated/floor/tiled,/area/map_template/facility/start)
"kL" = (/obj/floor_decal/borderfloorblack/corner,/obj/floor_decal/corner/blue/three_quarters{dir = 8},/turf/simulated/floor/tiled/dark,/area/map_template/facility/start)
"lr" = (/obj/floor_decal/corner/red/mono,/obj/floor_decal/industrial/outline/yellow,/obj/random/maintenance,/obj/random/maintenance,/obj/random/loot,/obj/random/facility/gun/rare,/obj/structure/closet/secure_closet{name = "Equipment Locker"; req_access = list("ACCESS_FACILITY_SEC")},/turf/simulated/floor/tiled/dark/monotile,/area/map_template/facility/start)
"ls" = (/turf/space,/area/map_template/facility/start)
"lL" = (/obj/floor_decal/corner/blue{dir = 10},/obj/structure/extinguisher_cabinet{pixel_y = -32},/turf/simulated/floor/tiled,/area/map_template/facility/start)
"mu" = (/obj/floor_decal/corner/blue{dir = 8},/turf/simulated/floor/tiled,/area/map_template/facility/start)
"mU" = (/turf/simulated/floor/tiled/steel_ridged,/area/map_template/facility/start)
"nr" = (/obj/floor_decal/corner/red/mono,/obj/floor_decal/industrial/outline/yellow,/obj/machinery/photocopier,/turf/simulated/floor/tiled/dark/monotile,/area/map_template/facility/start)
"ny" = (/obj/floor_decal/borderfloorblack{dir = 4},/obj/floor_decal/corner/red{dir = 9},/obj/machinery/light{dir = 4},/obj/structure/railing/mapped{dir = 8; icon_state = "railing0-1"},/turf/simulated/floor/tiled/dark,/area/map_template/facility/start)
"ot" = (/obj/floor_decal/corner/red{dir = 5},/obj/random/trash,/turf/simulated/floor/tiled,/area/map_template/facility/start)
"oM" = (/obj/floor_decal/industrial/warning,/turf/simulated/floor/reinforced,/area/map_template/facility/start)
"oO" = (/obj/floor_decal/corner/blue{dir = 9},/turf/simulated/floor/tiled,/area/map_template/facility/start)
"qr" = (/obj/floor_decal/corner/blue{dir = 9},/obj/machinery/light/small{dir = 8},/turf/simulated/floor/tiled,/area/map_template/facility/start)
"qS" = (/obj/floor_decal/borderfloorblack{dir = 8},/obj/floor_decal/corner/blue,/obj/floor_decal/corner/red{dir = 4},/turf/simulated/floor/tiled/dark,/area/map_template/facility/start)
"rv" = (/obj/bump_teleporter{id = "facility_start"; name = "bump-teleporter from hangar"; density = 0},/obj/floor_decal/industrial/warning/fulltile,/turf/simulated/floor/reinforced,/area/map_template/facility/start)
"sl" = (/obj/floor_decal/corner/blue{dir = 6},/obj/structure/holoplant{pixel_y = 10},/turf/simulated/floor/tiled,/area/map_template/facility/start)
"sm" = (/obj/floor_decal/corner/blue{dir = 5},/obj/machinery/light{dir = 1},/turf/simulated/floor/tiled,/area/map_template/facility/start)
"sE" = (/obj/floor_decal/borderfloorblack,/obj/floor_decal/corner/red{dir = 5},/obj/machinery/light,/obj/structure/railing/mapped{dir = 1; icon_state = "railing0-1"},/turf/simulated/floor/tiled/dark,/area/map_template/facility/start)
"sH" = (/obj/machinery/door/airlock/command{name = "Facility Entrance"},/turf/simulated/floor/tiled/steel_ridged,/area/map_template/facility/start)
"sS" = (/obj/random/trash,/turf/simulated/floor/tiled/dark,/area/map_template/facility/start)
"sW" = (/obj/floor_decal/borderfloorblack{dir = 5},/obj/floor_decal/corner/blue{dir = 8},/turf/simulated/floor/tiled/dark,/area/map_template/facility/start)
"ti" = (/obj/floor_decal/corner/red{dir = 5},/turf/simulated/floor/tiled,/area/map_template/facility/start)
"tJ" = (/obj/structure/bed/chair/office/comfy/red{dir = 8},/turf/simulated/floor/tiled/dark,/area/map_template/facility/start)
"uI" = (/obj/floor_decal/corner/blue{dir = 10},/obj/machinery/light,/obj/random/facility/ammo,/turf/simulated/floor/tiled,/area/map_template/facility/start)
"uX" = (/obj/floor_decal/borderfloorblack{dir = 1},/obj/floor_decal/corner/blue{dir = 10},/obj/random/trash,/turf/simulated/floor/tiled/dark,/area/map_template/facility/start)
"vp" = (/obj/floor_decal/borderfloorblack{dir = 8},/obj/floor_decal/corner/blue{dir = 6},/obj/random/facility/gun/uncommon,/obj/landmark/corpse/facility/mercenary,/turf/simulated/floor/tiled/dark,/area/map_template/facility/start)
"vu" = (/obj/floor_decal/borderfloorblack/corner{dir = 4},/obj/floor_decal/corner/red{dir = 1},/obj/floor_decal/corner/blue{dir = 10},/obj/structure/holoplant,/turf/simulated/floor/tiled/dark,/area/map_template/facility/start)
"vG" = (/obj/floor_decal/industrial/warning{dir = 5},/turf/simulated/floor/reinforced,/area/map_template/facility/start)
"vL" = (/obj/floor_decal/borderfloorblack{dir = 5},/obj/floor_decal/corner/red{dir = 8},/turf/simulated/floor/tiled/dark,/area/map_template/facility/start)
"vS" = (/obj/floor_decal/industrial/outline/yellow,/obj/machinery/hologram/holopad/longrange,/turf/simulated/floor/tiled/dark/monotile,/area/map_template/facility/start)
"wO" = (/obj/floor_decal/corner/blue{dir = 9},/obj/random/trash,/turf/simulated/floor/tiled,/area/map_template/facility/start)
"xu" = (/obj/floor_decal/borderfloorblack{dir = 6},/obj/floor_decal/corner/red{dir = 1},/turf/simulated/floor/tiled/dark,/area/map_template/facility/start)
"xJ" = (/obj/floor_decal/corner/red{dir = 6},/obj/random/facility/gun/uncommon,/obj/landmark/corpse/facility/mercenary,/turf/simulated/floor/tiled,/area/map_template/facility/start)
"yk" = (/obj/machinery/light/small{dir = 8},/turf/simulated/floor/tiled/steel_grid,/area/map_template/facility/start)
"yP" = (/obj/wallframe_spawn/reinforced,/turf/simulated/floor/plating,/area/map_template/facility/start)
"zb" = (/obj/random/trash,/turf/simulated/floor/tiled/steel_grid,/area/map_template/facility/start)
"zm" = (/obj/structure/sign/warning/nosmoking_1{pixel_y = 24},/turf/simulated/floor/tiled/dark,/area/map_template/facility/start)
"zt" = (/obj/floor_decal/borderfloorblack{dir = 8},/obj/floor_decal/corner/blue{dir = 4},/obj/floor_decal/corner/red,/turf/simulated/floor/tiled/dark,/area/map_template/facility/start)
"zv" = (/obj/floor_decal/borderfloorblack{dir = 1},/obj/floor_decal/corner/red{dir = 10},/obj/machinery/light{dir = 1},/obj/structure/railing/mapped,/turf/simulated/floor/tiled/dark,/area/map_template/facility/start)
"zK" = (/obj/floor_decal/industrial/warning{dir = 8},/turf/simulated/floor/reinforced,/area/map_template/facility/start)
"BI" = (/obj/floor_decal/corner/blue{dir = 9},/obj/structure/extinguisher_cabinet{pixel_x = -32},/turf/simulated/floor/tiled,/area/map_template/facility/start)
"CZ" = (/obj/floor_decal/corner/blue{dir = 9},/obj/random/facility/ammo,/turf/simulated/floor/tiled,/area/map_template/facility/start)
"DC" = (/obj/floor_decal/borderfloorblack{dir = 1},/obj/floor_decal/corner/red{dir = 10},/obj/structure/railing/mapped,/obj/structure/sign/warning/detailed{pixel_y = 32},/turf/simulated/floor/tiled/dark,/area/map_template/facility/start)
"DU" = (/obj/floor_decal/corner/blue{dir = 6},/turf/simulated/floor/tiled,/area/map_template/facility/start)
"DZ" = (/obj/floor_decal/corner/red/border{dir = 8},/obj/floor_decal/borderfloorblack{dir = 4},/obj/structure/table/steel_reinforced,/obj/machinery/recharger{pixel_x = -4},/turf/simulated/floor/tiled/dark/monotile,/area/map_template/facility/start)
"Ex" = (/obj/floor_decal/corner/red/border{dir = 4},/obj/floor_decal/borderfloorblack{dir = 8},/obj/machinery/computer/modular/preset/security{dir = 8; icon_state = "console"},/obj/machinery/recharger/wallcharger{dir = 8; pixel_x = 23; pixel_y = -3},/turf/simulated/floor/tiled/dark/monotile,/area/map_template/facility/start)
"EK" = (/obj/machinery/door/airlock/civilian,/turf/simulated/floor/tiled/steel_ridged,/area/map_template/facility/start)
"Fj" = (/obj/floor_decal/borderfloorblack{dir = 4},/obj/floor_decal/corner/blue{dir = 9},/obj/random/trash,/turf/simulated/floor/tiled/dark,/area/map_template/facility/start)
"GE" = (/obj/floor_decal/corner/blue{dir = 8},/obj/floor_decal/corner/red{dir = 1},/obj/floor_decal/corner/red,/turf/simulated/floor/tiled,/area/map_template/facility/start)
"Hn" = (/obj/machinery/door/airlock/civilian{name = "Auxiliary Head"},/turf/simulated/floor/tiled/steel_ridged,/area/map_template/facility/start)
"HC" = (/obj/floor_decal/corner/blue{dir = 6},/obj/structure/sign/warning/smoking{dir = 8; pixel_x = 32},/turf/simulated/floor/tiled,/area/map_template/facility/start)
"IF" = (/obj/wallframe_spawn/reinforced/crescent,/turf/simulated/floor/plating,/area/map_template/facility/start)
"IO" = (/obj/floor_decal/corner/blue{dir = 5},/obj/floor_decal/corner/red{dir = 8},/obj/structure/sign/warning/detailed{pixel_y = 32},/obj/machinery/vending/cola,/turf/simulated/floor/tiled,/area/map_template/facility/start)
"Js" = (/turf/simulated/wall/prepainted,/area/map_template/facility/start)
"JG" = (/obj/machinery/door/unpowered/simple/iron,/turf/simulated/floor/tiled/steel_ridged,/area/map_template/facility/start)
"Kb" = (/obj/floor_decal/corner/red/border{dir = 4},/obj/floor_decal/borderfloorblack{dir = 8},/obj/structure/filingcabinet,/obj/machinery/recharger/wallcharger{dir = 8; pixel_x = 23; pixel_y = -3},/turf/simulated/floor/tiled/dark/monotile,/area/map_template/facility/start)
"Kn" = (/obj/floor_decal/corner/red/border{dir = 4},/obj/floor_decal/borderfloorblack{dir = 8},/obj/structure/table/steel_reinforced,/obj/machinery/light{dir = 4},/obj/random/maintenance,/turf/simulated/floor/tiled/dark/monotile,/area/map_template/facility/start)
"KB" = (/obj/floor_decal/corner/red/mono,/obj/floor_decal/industrial/outline/yellow,/obj/machinery/papershredder,/turf/simulated/floor/tiled/dark/monotile,/area/map_template/facility/start)
"KD" = (/obj/floor_decal/corner/blue{dir = 1},/obj/random/trash,/turf/simulated/floor/tiled,/area/map_template/facility/start)
"KF" = (/obj/floor_decal/industrial/warning{dir = 6},/turf/simulated/floor/reinforced,/area/map_template/facility/start)
"KJ" = (/obj/machinery/door/airlock/highsecurity{name = "Facility Gateway"},/turf/simulated/floor/tiled/dark/monotile,/area/map_template/facility/start)
"KS" = (/obj/wallframe_spawn/no_grille,/turf/simulated/floor/plating,/area/map_template/facility/start)
"KX" = (/obj/floor_decal/corner/blue{dir = 10},/turf/simulated/floor/tiled,/area/map_template/facility/start)
"Lk" = (/obj/floor_decal/borderfloorblack{dir = 4},/obj/floor_decal/corner/blue{dir = 9},/turf/simulated/floor/tiled/dark,/area/map_template/facility/start)
"Lu" = (/obj/floor_decal/corner/blue{dir = 10},/obj/random/trash,/turf/simulated/floor/tiled,/area/map_template/facility/start)
"LC" = (/obj/floor_decal/corner/red{dir = 10},/turf/simulated/floor/tiled/steel_grid,/area/map_template/facility/start)
"LL" = (/obj/floor_decal/borderfloorblack{dir = 10},/obj/floor_decal/corner/red{dir = 4},/turf/simulated/floor/tiled/dark,/area/map_template/facility/start)
"LR" = (/obj/floor_decal/borderfloorblack{dir = 9},/obj/floor_decal/corner/red,/obj/structure/sign/warning/caution{pixel_y = 32},/turf/simulated/floor/tiled/dark,/area/map_template/facility/start)
"MU" = (/obj/floor_decal/borderfloorblack/corner{dir = 4},/obj/floor_decal/corner/blue/three_quarters,/obj/structure/table/standard,/obj/random/snack,/obj/random/snack,/turf/simulated/floor/tiled/dark,/area/map_template/facility/start)
"Nm" = (/obj/floor_decal/borderfloorblack,/obj/floor_decal/corner/red{dir = 5},/obj/structure/railing/mapped{dir = 1; icon_state = "railing0-1"},/turf/simulated/floor/tiled/dark,/area/map_template/facility/start)
"Pc" = (/obj/structure/hygiene/sink{dir = 1; pixel_y = 16},/obj/floor_decal/corner/grey{dir = 10},/obj/floor_decal/borderfloor{dir = 1},/obj/structure/sign/warning/smoking{dir = 8; pixel_x = 32},/turf/simulated/floor/tiled,/area/map_template/facility/start)
"Pw" = (/turf/simulated/wall/invincible/prepainted,/area/map_template/facility/start)
"PS" = (/obj/structure/table/glass,/obj/item/towel/random,/obj/floor_decal/corner/grey{dir = 10},/obj/floor_decal/borderfloor{dir = 1},/turf/simulated/floor/tiled,/area/map_template/facility/start)
"Qa" = (/obj/floor_decal/corner/red{dir = 9},/turf/simulated/floor/tiled/steel_grid,/area/map_template/facility/start)
"Qp" = (/obj/floor_decal/borderfloorblack{dir = 4},/obj/floor_decal/corner/red{dir = 9},/turf/simulated/floor/tiled/dark,/area/map_template/facility/start)
"QP" = (/obj/floor_decal/corner/red/border{dir = 4},/obj/floor_decal/borderfloorblack{dir = 8},/obj/structure/table/steel_reinforced,/obj/random/powercell,/turf/simulated/floor/tiled/dark/monotile,/area/map_template/facility/start)
"Rd" = (/obj/floor_decal/borderfloorblack{dir = 1},/obj/floor_decal/corner/red{dir = 10},/turf/simulated/floor/tiled/dark,/area/map_template/facility/start)
"Rp" = (/obj/floor_decal/corner/red/mono,/obj/structure/table/steel_reinforced,/obj/random/maintenance,/turf/simulated/floor/tiled/dark/monotile,/area/map_template/facility/start)
"Rs" = (/obj/floor_decal/industrial/warning{dir = 9},/turf/simulated/floor/reinforced,/area/map_template/facility/start)
"Sg" = (/obj/floor_decal/borderfloorblack{dir = 6},/obj/floor_decal/corner/blue{dir = 1},/obj/random/facility/ammo,/turf/simulated/floor/tiled/dark,/area/map_template/facility/start)
"SS" = (/obj/catwalk_plated,/turf/simulated/floor/plating,/area/map_template/facility/start)
"To" = (/obj/floor_decal/corner/blue{dir = 10},/obj/landmark/corpse/facility/mercenary,/turf/simulated/floor/tiled,/area/map_template/facility/start)
"Tz" = (/obj/floor_decal/corner/red{dir = 6},/turf/simulated/floor/tiled,/area/map_template/facility/start)
"Uf" = (/obj/floor_decal/corner/blue,/obj/floor_decal/corner/red{dir = 4},/obj/floor_decal/corner/red{dir = 8},/turf/simulated/floor/tiled,/area/map_template/facility/start)
"Ur" = (/obj/floor_decal/borderfloorblack/corner{dir = 1},/obj/floor_decal/corner/blue{dir = 10},/obj/floor_decal/corner/red{dir = 4},/obj/structure/sign/warning/nosmoking_1{dir = 8; pixel_x = 32},/turf/simulated/floor/tiled/dark,/area/map_template/facility/start)
"UD" = (/obj/floor_decal/corner/blue{dir = 9},/obj/machinery/light{dir = 8},/turf/simulated/floor/tiled,/area/map_template/facility/start)
"Va" = (/obj/floor_decal/industrial/warning{dir = 1},/turf/simulated/floor/reinforced,/area/map_template/facility/start)
"Vx" = (/obj/floor_decal/borderfloorblack{dir = 4},/obj/floor_decal/corner/red{dir = 8},/obj/floor_decal/corner/blue{dir = 1},/obj/machinery/light{dir = 8},/obj/random/trash,/turf/simulated/floor/tiled/dark,/area/map_template/facility/start)
"Wr" = (/obj/item/storage/mirror{pixel_y = 26},/obj/structure/table/glass,/obj/floor_decal/corner/grey{dir = 10},/obj/floor_decal/borderfloor{dir = 1},/turf/simulated/floor/tiled,/area/map_template/facility/start)
"Ws" = (/obj/floor_decal/corner/red/border{dir = 8},/obj/floor_decal/borderfloorblack{dir = 4},/obj/machinery/light{dir = 8},/obj/structure/holoplant,/turf/simulated/floor/tiled/dark/monotile,/area/map_template/facility/start)
"WC" = (/obj/random/facility/ammo,/turf/simulated/floor/tiled/steel_grid,/area/map_template/facility/start)
"WD" = (/obj/floor_decal/borderfloorblack,/obj/floor_decal/corner/blue{dir = 5},/obj/machinery/light{dir = 1},/obj/structure/bed/chair/padded/blue,/turf/simulated/floor/tiled/dark,/area/map_template/facility/start)
"WE" = (/obj/floor_decal/corner/red/border{dir = 8},/obj/floor_decal/borderfloorblack{dir = 4},/obj/machinery/computer/modular/preset/security{dir = 4; icon_state = "console"},/turf/simulated/floor/tiled/dark/monotile,/area/map_template/facility/start)
"WZ" = (/turf/simulated/wall/r_wall/prepainted,/area/map_template/facility/start)
"Xe" = (/obj/structure/bed/chair/office/comfy/red{dir = 4},/turf/simulated/floor/tiled/dark,/area/map_template/facility/start)
"XX" = (/obj/floor_decal/industrial/warning{dir = 4},/turf/simulated/floor/reinforced,/area/map_template/facility/start)
"XZ" = (/obj/floor_decal/corner/red/three_quarters,/obj/floor_decal/borderfloorblack/corner{dir = 4},/obj/random/trash,/turf/simulated/floor/tiled/dark,/area/map_template/facility/start)
"YJ" = (/obj/machinery/door/airlock/security{name = "Security Checkpoint"; stripe_color = "#FF0000"; hackProof = 1; secured_wires = 1; maxhealth = 300000; min_force = 100; destroy_hits = 10000; autoset_access = 0; req_access = list("ACCESS_FACILITY_SEC")},/turf/simulated/floor/tiled/dark/monotile,/area/map_template/facility/start)
"Za" = (/obj/machinery/light/small{dir = 4; icon_state = "bulb1"},/turf/simulated/floor/tiled/steel_grid,/area/map_template/facility/start)
"ZV" = (/obj/floor_decal/borderfloorblack{dir = 8},/obj/floor_decal/corner/red{dir = 6},/turf/simulated/floor/tiled/dark,/area/map_template/facility/start)

(1,1,1) = {"
PwPwPwPwmUPwPwPwPwPwPwPwPwPwPwPwPwPwPwPw
bIlsPwqrdeslJsPSWrPcJskLboJsLRDCzvfQvLPw
bIlsIFoOzbDUHndedeZaJsFjztyPZVRsVavGdoPw
bIlsIFoOdeHCJsJGJsJGJsjxZVKJZVzKrvXXnyPw
bIlsIFoOSSkCJsZaJsykJsivqSyPZVfvoMKFdoPw
bIlsPwoOSSDUJsitJsitJsdvisJsLLNmsENmxuPw
bIlsPwBISSDUJsJsJsJsJsLkeYPwPwPwPwPwPwPw
bIlsPwwOdeDUJshfeJWDeJSgisIFhEsSzmbcQPPw
bIlsPwoOdeaJJsMUkiuXkisWvpIFDZtJvSXeKnPw
bIlsIFoOdehSWZJsyPJsJsLkisIFWEbcbcbcExPw
bIlsIFoOSSTzKSIOdddWJsVxztPwWsbcbcsSKbPw
bIlsIFCZSSTzsHQaSSgdsHQpZVYJXZRdRdRdjRPw
bIlsPwUDSSTzKSGELCUfJsvuUrPwlrKBnrRpefPw
PwPwPwoOdexJWZKSsHKSWZWZWZPwPwIFIFIFPwPw
PwhvicKDdebltitiottibpsmicicicicicddhvPw
EKdedededeWCdeSSSSSSdededeSSSSSSdededemU
PwdHKXmudegtTouIKXKXKXLulLKXjiKXKXKXKXPw
PwPwPwoOzbDUPwPwIFIFIFPwPwPwPwIFIFIFPwPw
bIbIPwqrdeDUPwlslslslslslslslslslslslsPw
bIbIPwPwEKPwPwbIbIbIbIbIbIbIbIbIbIbIbIPw
"}
